user_id,reading_session,article_id,scroll_range,max_offset,min_offset,offset_difference,relative_time,reading_duration
111,00c29290-338e-42e9-8897-c475c799e1e5,30118783,7116,61,10,51,0,1
111,00c29290-338e-42e9-8897-c475c799e1e5,30118783,7116,0,0,0,1,1
111,2684b548-a936-46f8-90d7-3941bb9cd096,30345801,6830,203,5,198,0,1
111,2684b548-a936-46f8-90d7-3941bb9cd096,30345801,6830,336,0,-336,1,1
111,2684b548-a936-46f8-90d7-3941bb9cd096,30367210,5404,650,46,604,0,10
111,2684b548-a936-46f8-90d7-3941bb9cd096,30367210,5404,2674,651,2023,1,10
111,2684b548-a936-46f8-90d7-3941bb9cd096,30367210,5404,3374,2690,684,2,10
111,2684b548-a936-46f8-90d7-3941bb9cd096,30367210,5404,4313,3412,901,3,10
111,2684b548-a936-46f8-90d7-3941bb9cd096,30367210,5404,4314,4314,0,4,10
111,2684b548-a936-46f8-90d7-3941bb9cd096,30367210,5404,4214,4094,-120,5,10
111,2684b548-a936-46f8-90d7-3941bb9cd096,30367210,5404,3979,0,-3979,6,10
111,2684b548-a936-46f8-90d7-3941bb9cd096,30367210,5404,2041,55,1986,7,10
111,2684b548-a936-46f8-90d7-3941bb9cd096,30367210,5404,4130,2093,2037,8,10
111,2684b548-a936-46f8-90d7-3941bb9cd096,30367210,5416,4326,4191,135,9,10
111,2684b548-a936-46f8-90d7-3941bb9cd096,30367210,1090,0,0,0,10,10
111,8c8d8c80-2f20-4a44-9e12-29742765d49e,30373336,3166,41,21,20,0,237
111,8c8d8c80-2f20-4a44-9e12-29742765d49e,30373336,3166,155,50,105,228,237
111,8c8d8c80-2f20-4a44-9e12-29742765d49e,30373336,3166,1042,172,870,235,237
111,8c8d8c80-2f20-4a44-9e12-29742765d49e,30373336,3166,1425,494,-931,236,237
111,8c8d8c80-2f20-4a44-9e12-29742765d49e,30373336,3166,478,165,-313,237,237
111,8c8d8c80-2f20-4a44-9e12-29742765d49e,30370570,1732,163,82,81,0,2
111,8c8d8c80-2f20-4a44-9e12-29742765d49e,30370570,1744,654,180,474,1,2
111,8c8d8c80-2f20-4a44-9e12-29742765d49e,30370570,1732,584,0,-584,2,2
111,a79efb45-0797-4bb2-9d1e-bc8ae9002b2f,30371222,4914,200,0,-200,0,3
111,a79efb45-0797-4bb2-9d1e-bc8ae9002b2f,30371222,4914,293,5,288,1,3
111,a79efb45-0797-4bb2-9d1e-bc8ae9002b2f,30371222,4914,702,306,396,2,3
111,a79efb45-0797-4bb2-9d1e-bc8ae9002b2f,30371222,4914,860,675,-185,3,3
111,a79efb45-0797-4bb2-9d1e-bc8ae9002b2f,30368103,4416,114,24,90,0,1
111,a79efb45-0797-4bb2-9d1e-bc8ae9002b2f,30368103,4416,214,0,-214,1,1
111,7f43cc1a-ee02-409e-bdd3-1464a5dd339a,31534153,2944,365,70,295,0,2
111,7f43cc1a-ee02-409e-bdd3-1464a5dd339a,31534153,2944,283,0,-283,2,2
111,c7689cc2-4210-4fd1-9d4b-b8884ce591e9,31532755,9380,304,33,271,0,2
111,c7689cc2-4210-4fd1-9d4b-b8884ce591e9,31532755,9380,531,0,-531,1,2
111,c7689cc2-4210-4fd1-9d4b-b8884ce591e9,31532755,9385,0,0,0,2,2
111,c7689cc2-4210-4fd1-9d4b-b8884ce591e9,31532755,9383,0,0,0,2,2
111,c7689cc2-4210-4fd1-9d4b-b8884ce591e9,31532755,9382,0,0,0,2,2
111,c7689cc2-4210-4fd1-9d4b-b8884ce591e9,31532755,9381,0,0,0,2,2
111,c7689cc2-4210-4fd1-9d4b-b8884ce591e9,31532755,9380,0,0,0,2,2
111,b49e6211-9b6a-432b-bce6-03ea460529d1,31554844,3690,637,0,-637,0,13
111,b49e6211-9b6a-432b-bce6-03ea460529d1,31554844,3690,794,0,-794,1,13
111,b49e6211-9b6a-432b-bce6-03ea460529d1,31554844,3690,26,0,-26,2,13
111,b49e6211-9b6a-432b-bce6-03ea460529d1,31554844,3690,141,31,110,9,13
111,b49e6211-9b6a-432b-bce6-03ea460529d1,31554844,3690,575,124,451,10,13
111,b49e6211-9b6a-432b-bce6-03ea460529d1,31554844,3690,1242,609,-633,11,13
111,b49e6211-9b6a-432b-bce6-03ea460529d1,31554844,3690,1332,580,-752,12,13
111,b49e6211-9b6a-432b-bce6-03ea460529d1,31554844,3690,1284,0,-1284,13,13
111,39039618-ec57-4d60-b0c8-097a6811968a,31589202,9400,191,0,-191,0,0
111,35576f94-f792-4c4d-aef5-f1ca9a53626d,31586980,2850,315,59,256,0,2
111,35576f94-f792-4c4d-aef5-f1ca9a53626d,31586980,2850,288,0,-288,1,2
111,35576f94-f792-4c4d-aef5-f1ca9a53626d,31586980,2850,16,0,-16,2,2
111,35576f94-f792-4c4d-aef5-f1ca9a53626d,31582399,6666,473,36,437,0,0
111,35576f94-f792-4c4d-aef5-f1ca9a53626d,31585149,2988,9,1,8,0,11
111,35576f94-f792-4c4d-aef5-f1ca9a53626d,31585149,2988,207,0,207,1,11
111,35576f94-f792-4c4d-aef5-f1ca9a53626d,31585149,3000,1910,252,1658,2,11
111,35576f94-f792-4c4d-aef5-f1ca9a53626d,31585149,2988,1864,1765,-99,3,11
111,35576f94-f792-4c4d-aef5-f1ca9a53626d,31585149,2988,1745,1504,-241,4,11
111,35576f94-f792-4c4d-aef5-f1ca9a53626d,31585149,2988,1460,574,-886,10,11
111,35576f94-f792-4c4d-aef5-f1ca9a53626d,31585149,2988,541,0,-541,11,11
111,35576f94-f792-4c4d-aef5-f1ca9a53626d,31587621,3772,411,54,357,0,3
111,35576f94-f792-4c4d-aef5-f1ca9a53626d,31587621,3772,915,434,481,2,3
111,35576f94-f792-4c4d-aef5-f1ca9a53626d,31587621,3772,927,0,-927,3,3
111,35576f94-f792-4c4d-aef5-f1ca9a53626d,31589202,9400,427,62,365,0,1
111,35576f94-f792-4c4d-aef5-f1ca9a53626d,31589202,9400,340,0,-340,1,1
111,35576f94-f792-4c4d-aef5-f1ca9a53626d,31582826,2132,311,42,269,0,5
111,35576f94-f792-4c4d-aef5-f1ca9a53626d,31582826,2132,502,317,185,1,5
111,35576f94-f792-4c4d-aef5-f1ca9a53626d,31582826,2132,616,518,98,2,5
111,35576f94-f792-4c4d-aef5-f1ca9a53626d,31582826,2132,729,628,101,3,5
111,35576f94-f792-4c4d-aef5-f1ca9a53626d,31582826,2132,1027,741,286,4,5
111,35576f94-f792-4c4d-aef5-f1ca9a53626d,31582826,2132,971,0,-971,5,5
111,a6fbba83-556c-4b95-9cf6-76f112ff6cee,31730542,8220,29,1,28,0,1
111,a6fbba83-556c-4b95-9cf6-76f112ff6cee,31730542,8220,30,30,0,1,1
111,96ec40d6-3ddc-40d6-b043-a9cb2c2bcbc1,31831857,9498,43,36,7,0,2
111,96ec40d6-3ddc-40d6-b043-a9cb2c2bcbc1,31831857,9498,453,73,380,1,2
111,96ec40d6-3ddc-40d6-b043-a9cb2c2bcbc1,31831857,9498,456,454,2,2,2
111,c0d61561-3f7c-48c6-9f5f-e900c7ec46e4,31832392,6818,273,173,100,0,4
111,c0d61561-3f7c-48c6-9f5f-e900c7ec46e4,31832392,6818,784,276,508,1,4
111,c0d61561-3f7c-48c6-9f5f-e900c7ec46e4,31832392,6818,1811,808,1003,2,4
111,c0d61561-3f7c-48c6-9f5f-e900c7ec46e4,31832392,6818,2276,1504,-772,3,4
111,c0d61561-3f7c-48c6-9f5f-e900c7ec46e4,31832392,6818,1454,0,-1454,4,4
111,20208a99-6c52-489c-aa03-8b6f86532360,31835198,2474,1384,294,1090,0,2
111,20208a99-6c52-489c-aa03-8b6f86532360,31835198,2474,1342,1206,-136,1,2
111,20208a99-6c52-489c-aa03-8b6f86532360,31835198,2474,1159,0,-1159,2,2
111,1054b847-a347-4859-85c3-c39ae253659c,31956026,10240,229,0,-229,0,0
111,de29cda7-59e6-43e3-b469-b7c2be33a4f0,32091020,4404,2200,188,2012,0,1
111,de29cda7-59e6-43e3-b469-b7c2be33a4f0,32091020,4416,3326,2308,1018,1,1
111,b8e65d29-1df2-4133-87c9-581828fd0fc3,32083181,5426,3672,159,3513,0,13
111,b8e65d29-1df2-4133-87c9-581828fd0fc3,32083181,5438,4348,3405,-943,1,13
111,b8e65d29-1df2-4133-87c9-581828fd0fc3,32083181,5426,3301,0,-3301,2,13
111,b8e65d29-1df2-4133-87c9-581828fd0fc3,32083181,5438,4348,1583,2765,3,13
111,b8e65d29-1df2-4133-87c9-581828fd0fc3,32083181,5426,4240,0,-4240,6,13
111,b8e65d29-1df2-4133-87c9-581828fd0fc3,32083181,5426,868,53,815,10,13
111,b8e65d29-1df2-4133-87c9-581828fd0fc3,32083181,5438,4348,969,3379,12,13
111,b8e65d29-1df2-4133-87c9-581828fd0fc3,32083181,5428,4338,4336,-2,13,13
111,0a00faa2-c867-4d14-a3f3-5e03cb3f87b3,32082660,3170,2080,213,1867,0,3
111,0a00faa2-c867-4d14-a3f3-5e03cb3f87b3,32082660,3158,2017,88,-1929,1,3
111,0a00faa2-c867-4d14-a3f3-5e03cb3f87b3,32082660,3158,1043,0,1043,2,3
111,0a00faa2-c867-4d14-a3f3-5e03cb3f87b3,32082660,3158,1047,0,-1047,3,3
111,8592e996-3cbb-452c-87b9-c3f467a9a16b,32157686,5694,211,59,152,0,6
111,8592e996-3cbb-452c-87b9-c3f467a9a16b,32157686,5694,1004,246,758,1,6
111,8592e996-3cbb-452c-87b9-c3f467a9a16b,32157686,5694,2011,1044,967,2,6
111,8592e996-3cbb-452c-87b9-c3f467a9a16b,32157686,5694,3012,2032,980,3,6
111,8592e996-3cbb-452c-87b9-c3f467a9a16b,32157686,5706,4616,3017,1599,4,6
111,8592e996-3cbb-452c-87b9-c3f467a9a16b,32157686,5694,4539,3168,-1371,5,6
111,8592e996-3cbb-452c-87b9-c3f467a9a16b,32157686,5694,3154,2616,-538,6,6
122,97da3dcc-eb6e-428a-b9fb-4fd992e33983,36522510,7770,581,10,571,0,6
122,97da3dcc-eb6e-428a-b9fb-4fd992e33983,36522510,7770,944,613,331,1,6
122,97da3dcc-eb6e-428a-b9fb-4fd992e33983,36522510,7770,1083,785,298,3,6
122,97da3dcc-eb6e-428a-b9fb-4fd992e33983,36522510,7770,1604,1088,516,4,6
122,97da3dcc-eb6e-428a-b9fb-4fd992e33983,36522510,7770,2040,1614,426,5,6
122,97da3dcc-eb6e-428a-b9fb-4fd992e33983,36522510,7770,2425,2069,356,6,6
124,c163ec0f-3639-49ef-b926-1965202de3be,36537821,4401,417,14,403,0,14
124,c163ec0f-3639-49ef-b926-1965202de3be,36537821,4401,2239,471,1768,1,14
124,c163ec0f-3639-49ef-b926-1965202de3be,36537821,4401,2828,2263,565,2,14
124,c163ec0f-3639-49ef-b926-1965202de3be,36537821,4401,2802,1159,-1643,4,14
124,c163ec0f-3639-49ef-b926-1965202de3be,36537821,4401,1114,496,-618,5,14
124,c163ec0f-3639-49ef-b926-1965202de3be,36537821,4401,480,98,-382,7,14
124,c163ec0f-3639-49ef-b926-1965202de3be,36537821,4401,96,47,-49,8,14
124,c163ec0f-3639-49ef-b926-1965202de3be,36537821,4401,582,77,505,9,14
124,c163ec0f-3639-49ef-b926-1965202de3be,36537821,4401,778,600,178,10,14
124,c163ec0f-3639-49ef-b926-1965202de3be,36537821,4401,1104,793,311,11,14
124,c163ec0f-3639-49ef-b926-1965202de3be,36537821,4401,1594,1108,486,12,14
124,c163ec0f-3639-49ef-b926-1965202de3be,36537821,4401,2075,1595,480,13,14
124,c163ec0f-3639-49ef-b926-1965202de3be,36537821,4401,2828,2084,744,14,14
124,d200eb88-976c-4f8c-86b4-3304e6eb7235,36551464,7222,2064,77,1987,0,7
124,d200eb88-976c-4f8c-86b4-3304e6eb7235,36551464,7222,2091,0,-2091,1,7
124,d200eb88-976c-4f8c-86b4-3304e6eb7235,36551464,7222,1388,33,1355,2,7
124,d200eb88-976c-4f8c-86b4-3304e6eb7235,36551464,7222,1398,1041,-357,3,7
124,d200eb88-976c-4f8c-86b4-3304e6eb7235,36551464,7222,1013,880,-133,4,7
124,d200eb88-976c-4f8c-86b4-3304e6eb7235,36551464,7222,1969,904,1065,5,7
124,d200eb88-976c-4f8c-86b4-3304e6eb7235,36551464,7222,1989,1973,16,6,7
124,d200eb88-976c-4f8c-86b4-3304e6eb7235,36551464,7222,1967,0,-1967,7,7
124,513d1613-1f1a-4cec-b619-3840f475df55,36551464,7222,305,5,300,0,7
124,513d1613-1f1a-4cec-b619-3840f475df55,36551464,7222,1105,337,768,1,7
124,513d1613-1f1a-4cec-b619-3840f475df55,36551464,7222,1807,1110,697,2,7
124,513d1613-1f1a-4cec-b619-3840f475df55,36551464,7222,2557,1821,736,3,7
124,513d1613-1f1a-4cec-b619-3840f475df55,36551464,7222,3058,2570,488,4,7
124,513d1613-1f1a-4cec-b619-3840f475df55,36551464,7222,3487,3061,426,5,7
124,513d1613-1f1a-4cec-b619-3840f475df55,36551464,7222,4858,3520,1338,6,7
124,513d1613-1f1a-4cec-b619-3840f475df55,36551464,7222,5272,4886,386,7,7
125,b7c0e75f-d9d6-4518-9605-e2d160f37fa4,36514116,8817,234,0,-234,0,12
125,b7c0e75f-d9d6-4518-9605-e2d160f37fa4,36514116,8817,1430,9,1421,2,12
125,b7c0e75f-d9d6-4518-9605-e2d160f37fa4,36514116,8817,1494,1376,-118,3,12
125,b7c0e75f-d9d6-4518-9605-e2d160f37fa4,36514116,8817,1420,1383,37,4,12
125,b7c0e75f-d9d6-4518-9605-e2d160f37fa4,36514116,8817,2499,1436,1063,5,12
125,b7c0e75f-d9d6-4518-9605-e2d160f37fa4,36514116,8817,2615,2514,101,6,12
125,b7c0e75f-d9d6-4518-9605-e2d160f37fa4,36514116,8817,2920,2615,305,11,12
125,b7c0e75f-d9d6-4518-9605-e2d160f37fa4,36514116,8817,3098,2930,168,12,12
125,b7c0e75f-d9d6-4518-9605-e2d160f37fa4,36549674,7419,927,36,891,0,66
125,b7c0e75f-d9d6-4518-9605-e2d160f37fa4,36549674,7419,970,942,28,1,66
125,b7c0e75f-d9d6-4518-9605-e2d160f37fa4,36549674,7419,1344,983,361,13,66
125,b7c0e75f-d9d6-4518-9605-e2d160f37fa4,36549674,7419,1633,1345,288,14,66
125,b7c0e75f-d9d6-4518-9605-e2d160f37fa4,36549674,7419,1714,1635,79,19,66
125,b7c0e75f-d9d6-4518-9605-e2d160f37fa4,36549674,7419,1864,1715,149,20,66
125,b7c0e75f-d9d6-4518-9605-e2d160f37fa4,36549674,7419,2014,1890,124,26,66
125,b7c0e75f-d9d6-4518-9605-e2d160f37fa4,36549674,7419,2331,2021,310,27,66
125,b7c0e75f-d9d6-4518-9605-e2d160f37fa4,36549674,7419,2476,2268,208,28,66
125,b7c0e75f-d9d6-4518-9605-e2d160f37fa4,36549674,7419,2699,2483,216,31,66
125,b7c0e75f-d9d6-4518-9605-e2d160f37fa4,36549674,7419,2986,2710,276,32,66
125,b7c0e75f-d9d6-4518-9605-e2d160f37fa4,36549674,7419,3561,2988,573,33,66
125,b7c0e75f-d9d6-4518-9605-e2d160f37fa4,36549674,7419,4284,3600,684,48,66
125,b7c0e75f-d9d6-4518-9605-e2d160f37fa4,36549674,7419,4690,4291,399,49,66
125,b7c0e75f-d9d6-4518-9605-e2d160f37fa4,36549674,7419,5754,4723,1031,66,66
124,0fbe240c-7015-4a2c-8924-735defe18174,36573970,3844,304,15,289,0,10
124,0fbe240c-7015-4a2c-8924-735defe18174,36573970,3844,1989,320,1669,1,10
124,0fbe240c-7015-4a2c-8924-735defe18174,36573970,3844,2271,2059,212,2,10
124,0fbe240c-7015-4a2c-8924-735defe18174,36573970,3844,2253,1320,-933,3,10
124,0fbe240c-7015-4a2c-8924-735defe18174,36573970,3844,1315,836,-479,4,10
124,0fbe240c-7015-4a2c-8924-735defe18174,36573970,3844,815,285,-530,5,10
124,0fbe240c-7015-4a2c-8924-735defe18174,36573970,3844,284,283,-1,6,10
124,0fbe240c-7015-4a2c-8924-735defe18174,36573970,3844,1333,289,1044,9,10
124,0fbe240c-7015-4a2c-8924-735defe18174,36573970,3844,2271,1353,918,10,10
124,0fbe240c-7015-4a2c-8924-735defe18174,36575493,6721,577,4,573,0,22
124,0fbe240c-7015-4a2c-8924-735defe18174,36575493,6721,1923,595,1328,1,22
124,0fbe240c-7015-4a2c-8924-735defe18174,36575493,6721,2551,1964,587,2,22
124,0fbe240c-7015-4a2c-8924-735defe18174,36575493,6721,3162,2575,587,3,22
124,0fbe240c-7015-4a2c-8924-735defe18174,36575493,6721,3392,3165,227,4,22
124,0fbe240c-7015-4a2c-8924-735defe18174,36575493,6721,3401,3394,7,5,22
124,0fbe240c-7015-4a2c-8924-735defe18174,36575493,6721,3493,3407,86,6,22
124,0fbe240c-7015-4a2c-8924-735defe18174,36575493,6721,3539,3494,45,7,22
124,0fbe240c-7015-4a2c-8924-735defe18174,36575493,6721,3811,3541,270,8,22
124,0fbe240c-7015-4a2c-8924-735defe18174,36575493,6721,3979,3815,164,9,22
124,0fbe240c-7015-4a2c-8924-735defe18174,36575493,6721,4546,3988,558,10,22
124,0fbe240c-7015-4a2c-8924-735defe18174,36575493,6721,4553,4547,6,20,22
124,0fbe240c-7015-4a2c-8924-735defe18174,36575493,6721,4894,4555,339,21,22
124,0fbe240c-7015-4a2c-8924-735defe18174,36575493,6721,5148,4896,252,22,22
127,bc630298-b14e-431e-a1ef-b39ec6cc385c,36572649,6411,528,4,524,0,17
127,bc630298-b14e-431e-a1ef-b39ec6cc385c,36572649,6411,603,538,65,1,17
127,bc630298-b14e-431e-a1ef-b39ec6cc385c,36572649,6411,818,605,213,8,17
127,bc630298-b14e-431e-a1ef-b39ec6cc385c,36572649,6411,1087,844,243,9,17
127,bc630298-b14e-431e-a1ef-b39ec6cc385c,36572649,6411,1467,1110,357,13,17
127,bc630298-b14e-431e-a1ef-b39ec6cc385c,36572649,6411,2344,1472,872,14,17
127,bc630298-b14e-431e-a1ef-b39ec6cc385c,36572649,6411,3272,2359,913,15,17
127,bc630298-b14e-431e-a1ef-b39ec6cc385c,36572649,6411,4258,3326,932,16,17
127,bc630298-b14e-431e-a1ef-b39ec6cc385c,36572649,6411,4838,4285,553,17,17
129,aa4ea3f6-0724-48b6-b7e4-2258e8032fbe,36573757,7364,235,8,227,0,17
129,aa4ea3f6-0724-48b6-b7e4-2258e8032fbe,36573757,7364,235,8,-227,0,17
129,aa4ea3f6-0724-48b6-b7e4-2258e8032fbe,36573757,7364,583,244,339,1,17
129,aa4ea3f6-0724-48b6-b7e4-2258e8032fbe,36573757,7364,583,244,-339,1,17
129,aa4ea3f6-0724-48b6-b7e4-2258e8032fbe,36573757,7364,586,584,2,2,17
129,aa4ea3f6-0724-48b6-b7e4-2258e8032fbe,36573757,7364,586,584,-2,2,17
129,aa4ea3f6-0724-48b6-b7e4-2258e8032fbe,36573757,7364,1143,609,534,15,17
129,aa4ea3f6-0724-48b6-b7e4-2258e8032fbe,36573757,7364,1143,609,-534,15,17
129,aa4ea3f6-0724-48b6-b7e4-2258e8032fbe,36573757,7364,1644,1161,483,16,17
129,aa4ea3f6-0724-48b6-b7e4-2258e8032fbe,36573757,7364,1644,1161,-483,16,17
129,aa4ea3f6-0724-48b6-b7e4-2258e8032fbe,36573757,7364,1645,1645,0,17,17
124,801d5586-3760-4e4e-a861-e3e7d19ceaf7,36575947,3340,181,3,178,0,29
124,801d5586-3760-4e4e-a861-e3e7d19ceaf7,36575947,3340,309,188,121,1,29
124,801d5586-3760-4e4e-a861-e3e7d19ceaf7,36575947,3340,459,316,143,3,29
124,801d5586-3760-4e4e-a861-e3e7d19ceaf7,36575947,3340,624,463,161,4,29
124,801d5586-3760-4e4e-a861-e3e7d19ceaf7,36575947,3340,748,628,120,5,29
124,801d5586-3760-4e4e-a861-e3e7d19ceaf7,36575947,3340,1023,759,264,19,29
124,801d5586-3760-4e4e-a861-e3e7d19ceaf7,36575947,3340,1344,1030,314,20,29
124,801d5586-3760-4e4e-a861-e3e7d19ceaf7,36575947,3340,1522,1361,161,21,29
124,801d5586-3760-4e4e-a861-e3e7d19ceaf7,36575947,3340,1580,1527,53,28,29
124,801d5586-3760-4e4e-a861-e3e7d19ceaf7,36575947,3340,1767,1601,166,29,29
128,f600d2ea-2e65-41c1-9e8d-2521dc66100c,36584812,9688,7464,119,7345,0,0
126,1d9adefa-660e-4ef1-ba52-35804f55c520,36590824,4296,24,2,22,0,5
126,1d9adefa-660e-4ef1-ba52-35804f55c520,36590824,4296,32,26,6,1,5
126,1d9adefa-660e-4ef1-ba52-35804f55c520,36590824,4296,47,33,14,2,5
126,1d9adefa-660e-4ef1-ba52-35804f55c520,36590824,4296,45,14,-31,3,5
126,1d9adefa-660e-4ef1-ba52-35804f55c520,36590824,4296,808,53,755,4,5
126,1d9adefa-660e-4ef1-ba52-35804f55c520,36590824,4296,2758,810,1948,5,5
126,1d9adefa-660e-4ef1-ba52-35804f55c520,36524213,11824,711,9,702,0,18
126,1d9adefa-660e-4ef1-ba52-35804f55c520,36524213,11824,1396,718,678,2,18
126,1d9adefa-660e-4ef1-ba52-35804f55c520,36524213,11824,1434,1399,35,3,18
126,1d9adefa-660e-4ef1-ba52-35804f55c520,36524213,11824,2254,1433,821,4,18
126,1d9adefa-660e-4ef1-ba52-35804f55c520,36524213,11824,2694,2263,431,5,18
126,1d9adefa-660e-4ef1-ba52-35804f55c520,36524213,11824,3273,2731,542,6,18
126,1d9adefa-660e-4ef1-ba52-35804f55c520,36524213,11824,4400,3274,1126,7,18
126,1d9adefa-660e-4ef1-ba52-35804f55c520,36524213,11824,5028,4417,611,8,18
126,1d9adefa-660e-4ef1-ba52-35804f55c520,36524213,11824,8798,5070,3728,9,18
126,1d9adefa-660e-4ef1-ba52-35804f55c520,36524213,11824,10616,8902,1714,10,18
126,1d9adefa-660e-4ef1-ba52-35804f55c520,36524213,11824,10714,10714,0,11,18
126,1d9adefa-660e-4ef1-ba52-35804f55c520,36524213,11824,10701,0,-10701,12,18
126,1d9adefa-660e-4ef1-ba52-35804f55c520,36524213,11824,28,9,19,14,18
126,1d9adefa-660e-4ef1-ba52-35804f55c520,36524213,11824,84,29,55,15,18
126,1d9adefa-660e-4ef1-ba52-35804f55c520,36524213,11824,669,87,582,16,18
126,1d9adefa-660e-4ef1-ba52-35804f55c520,36524213,11824,7024,684,6340,17,18
126,1d9adefa-660e-4ef1-ba52-35804f55c520,36524213,11824,8190,7100,1090,18,18
128,2e687d20-677c-47dd-8914-91dcf7ec9562,36580159,13184,872,13,859,0,14
128,2e687d20-677c-47dd-8914-91dcf7ec9562,36580159,13184,2251,829,1422,1,14
128,2e687d20-677c-47dd-8914-91dcf7ec9562,36580159,13184,2764,2170,594,3,14
128,2e687d20-677c-47dd-8914-91dcf7ec9562,36580159,13184,3083,2797,-286,4,14
128,2e687d20-677c-47dd-8914-91dcf7ec9562,36580159,13184,2648,1933,-715,5,14
128,2e687d20-677c-47dd-8914-91dcf7ec9562,36580159,13184,2919,1964,955,9,14
128,2e687d20-677c-47dd-8914-91dcf7ec9562,36580159,13184,3953,2912,1041,10,14
128,2e687d20-677c-47dd-8914-91dcf7ec9562,36580159,13184,5734,3982,1752,11,14
128,2e687d20-677c-47dd-8914-91dcf7ec9562,36580159,13184,6918,5834,1084,12,14
128,2e687d20-677c-47dd-8914-91dcf7ec9562,36580159,13184,9791,6993,2798,13,14
128,2e687d20-677c-47dd-8914-91dcf7ec9562,36580159,13184,10960,9908,1052,14,14
126,1d9adefa-660e-4ef1-ba52-35804f55c520,36524212,12330,2472,192,2280,1,9
126,1d9adefa-660e-4ef1-ba52-35804f55c520,36524212,12330,7850,2528,5322,2,9
126,1d9adefa-660e-4ef1-ba52-35804f55c520,36524212,12330,11220,8058,3162,3,9
126,1d9adefa-660e-4ef1-ba52-35804f55c520,36524212,12330,11203,0,-11203,4,9
126,1d9adefa-660e-4ef1-ba52-35804f55c520,36524212,12330,2582,38,2544,6,9
126,1d9adefa-660e-4ef1-ba52-35804f55c520,36524212,12330,7661,2701,4960,7,9
126,1d9adefa-660e-4ef1-ba52-35804f55c520,36524212,12330,10228,7812,2416,8,9
126,1d9adefa-660e-4ef1-ba52-35804f55c520,36524212,12330,11220,10263,957,9,9
128,2e687d20-677c-47dd-8914-91dcf7ec9562,36590813,4404,65,65,0,0,13
128,2e687d20-677c-47dd-8914-91dcf7ec9562,36590813,4404,2180,171,2009,1,13
128,2e687d20-677c-47dd-8914-91dcf7ec9562,36590813,4404,2178,0,-2178,2,13
128,2e687d20-677c-47dd-8914-91dcf7ec9562,36590813,4404,2180,27,2153,9,13
128,2e687d20-677c-47dd-8914-91dcf7ec9562,36590813,4404,2163,0,-2163,10,13
128,2e687d20-677c-47dd-8914-91dcf7ec9562,36590813,4404,947,39,908,13,13
133,994c6021-ae57-4531-ace8-4c2ee91bf920,36524212,12330,27,27,0,0,13
133,994c6021-ae57-4531-ace8-4c2ee91bf920,36524212,12330,1122,64,1058,1,13
133,994c6021-ae57-4531-ace8-4c2ee91bf920,36524212,12330,1130,1124,6,2,13
133,994c6021-ae57-4531-ace8-4c2ee91bf920,36524212,12330,1086,403,-683,3,13
133,994c6021-ae57-4531-ace8-4c2ee91bf920,36524212,12330,402,0,-402,4,13
133,994c6021-ae57-4531-ace8-4c2ee91bf920,36524212,12330,99,99,0,7,13
133,994c6021-ae57-4531-ace8-4c2ee91bf920,36524212,12330,11128,322,10806,8,13
133,994c6021-ae57-4531-ace8-4c2ee91bf920,36524212,12330,11220,11218,2,9,13
133,994c6021-ae57-4531-ace8-4c2ee91bf920,36524212,12330,11219,10542,-677,10,13
133,994c6021-ae57-4531-ace8-4c2ee91bf920,36524212,12330,10527,9725,-802,11,13
133,994c6021-ae57-4531-ace8-4c2ee91bf920,36524212,12330,9674,8308,-1366,12,13
133,994c6021-ae57-4531-ace8-4c2ee91bf920,36524212,12330,8307,8305,-2,13,13
133,994c6021-ae57-4531-ace8-4c2ee91bf920,36579430,6392,0,0,0,0,69
133,994c6021-ae57-4531-ace8-4c2ee91bf920,36579430,6392,595,36,559,2,69
133,994c6021-ae57-4531-ace8-4c2ee91bf920,36579430,6392,1036,611,425,3,69
133,994c6021-ae57-4531-ace8-4c2ee91bf920,36579430,6392,1562,1064,498,5,69
133,994c6021-ae57-4531-ace8-4c2ee91bf920,36579430,6392,2031,9,2022,6,69
133,994c6021-ae57-4531-ace8-4c2ee91bf920,36579430,6392,2618,2049,569,20,69
133,994c6021-ae57-4531-ace8-4c2ee91bf920,36579430,6392,3223,2632,591,21,69
133,994c6021-ae57-4531-ace8-4c2ee91bf920,36579430,6392,3770,3240,530,22,69
133,994c6021-ae57-4531-ace8-4c2ee91bf920,36579430,6392,4257,3793,464,31,69
133,994c6021-ae57-4531-ace8-4c2ee91bf920,36579430,6392,4770,4265,505,33,69
133,994c6021-ae57-4531-ace8-4c2ee91bf920,36579430,6392,5158,4778,380,34,69
133,994c6021-ae57-4531-ace8-4c2ee91bf920,36579430,6392,5282,5177,105,35,69
133,994c6021-ae57-4531-ace8-4c2ee91bf920,36579430,6392,5258,4926,-332,46,69
133,994c6021-ae57-4531-ace8-4c2ee91bf920,36579430,6392,4894,4176,-718,47,69
133,994c6021-ae57-4531-ace8-4c2ee91bf920,36579430,6392,4162,3679,-483,48,69
133,994c6021-ae57-4531-ace8-4c2ee91bf920,36579430,6392,3665,3227,-438,49,69
133,994c6021-ae57-4531-ace8-4c2ee91bf920,36579430,6392,3722,3241,481,57,69
133,994c6021-ae57-4531-ace8-4c2ee91bf920,36579430,6392,4355,3737,618,58,69
133,994c6021-ae57-4531-ace8-4c2ee91bf920,36579430,6392,4880,4360,520,59,69
133,994c6021-ae57-4531-ace8-4c2ee91bf920,36579430,6392,5282,4895,387,69,69
130,1c23085d-0e52-494d-b85c-3fa8a10daabd,36594086,2331,489,7,482,0,2
130,1c23085d-0e52-494d-b85c-3fa8a10daabd,36594086,2331,746,497,249,1,2
130,1c23085d-0e52-494d-b85c-3fa8a10daabd,36594086,2331,807,749,58,2,2
8,d55522e0-32c2-48d9-afa5-5667b32578ce,36582567,11058,156,10,146,0,47
8,d55522e0-32c2-48d9-afa5-5667b32578ce,36582567,11058,250,158,92,1,47
8,d55522e0-32c2-48d9-afa5-5667b32578ce,36582567,11058,304,255,49,2,47
8,d55522e0-32c2-48d9-afa5-5667b32578ce,36582567,11058,257,0,-257,3,47
8,d55522e0-32c2-48d9-afa5-5667b32578ce,36582567,11058,126,8,118,23,47
8,d55522e0-32c2-48d9-afa5-5667b32578ce,36582567,11058,435,132,303,24,47
8,d55522e0-32c2-48d9-afa5-5667b32578ce,36582567,11058,715,447,268,25,47
8,d55522e0-32c2-48d9-afa5-5667b32578ce,36582567,11058,1006,717,289,26,47
8,d55522e0-32c2-48d9-afa5-5667b32578ce,36582567,11058,1184,1007,177,27,47
8,d55522e0-32c2-48d9-afa5-5667b32578ce,36582567,11058,1331,1201,130,28,47
8,d55522e0-32c2-48d9-afa5-5667b32578ce,36582567,11058,1483,1345,138,29,47
8,d55522e0-32c2-48d9-afa5-5667b32578ce,36582567,11058,1677,1491,186,30,47
8,d55522e0-32c2-48d9-afa5-5667b32578ce,36582567,11058,1759,1684,75,31,47
8,d55522e0-32c2-48d9-afa5-5667b32578ce,36582567,11058,1850,1770,80,32,47
8,d55522e0-32c2-48d9-afa5-5667b32578ce,36582567,11058,1930,1854,76,33,47
8,d55522e0-32c2-48d9-afa5-5667b32578ce,36582567,11058,1987,1937,50,34,47
8,d55522e0-32c2-48d9-afa5-5667b32578ce,36582567,11058,2588,1999,589,42,47
8,d55522e0-32c2-48d9-afa5-5667b32578ce,36582567,11058,2909,2591,318,43,47
8,d55522e0-32c2-48d9-afa5-5667b32578ce,36582567,11058,3599,2984,615,44,47
8,d55522e0-32c2-48d9-afa5-5667b32578ce,36582567,11058,4072,3600,472,45,47
8,d55522e0-32c2-48d9-afa5-5667b32578ce,36582567,11058,5284,4074,1210,46,47
8,d55522e0-32c2-48d9-afa5-5667b32578ce,36582567,11058,5564,5309,255,47,47
8,8edec827-9700-4fe7-985a-b0a4577086c8,36524210,17523,22,1,21,0,39
8,8edec827-9700-4fe7-985a-b0a4577086c8,36524210,17523,20,0,-20,1,39
8,8edec827-9700-4fe7-985a-b0a4577086c8,36524210,17523,21,0,-21,2,39
8,8edec827-9700-4fe7-985a-b0a4577086c8,36524210,17523,15,6,9,5,39
8,8edec827-9700-4fe7-985a-b0a4577086c8,36524210,17523,123,20,103,6,39
8,8edec827-9700-4fe7-985a-b0a4577086c8,36524210,17523,324,127,197,7,39
8,8edec827-9700-4fe7-985a-b0a4577086c8,36524210,17523,577,329,248,8,39
8,8edec827-9700-4fe7-985a-b0a4577086c8,36524210,17523,769,589,180,9,39
8,8edec827-9700-4fe7-985a-b0a4577086c8,36524210,17523,856,770,86,10,39
8,8edec827-9700-4fe7-985a-b0a4577086c8,36524210,17523,948,864,84,17,39
8,8edec827-9700-4fe7-985a-b0a4577086c8,36524210,17523,1389,989,400,34,39
8,8edec827-9700-4fe7-985a-b0a4577086c8,36524210,17523,1624,1393,231,35,39
8,8edec827-9700-4fe7-985a-b0a4577086c8,36524210,17523,1816,1637,179,39,39
126,ad874a06-052e-4706-855b-3eda4ceda380,36586021,4636,164,22,142,0,241
126,ad874a06-052e-4706-855b-3eda4ceda380,36586021,4636,406,194,212,1,241
126,ad874a06-052e-4706-855b-3eda4ceda380,36586021,4636,452,411,41,6,241
126,ad874a06-052e-4706-855b-3eda4ceda380,36586021,4636,586,455,131,7,241
126,ad874a06-052e-4706-855b-3eda4ceda380,36586021,4636,587,587,0,8,241
126,ad874a06-052e-4706-855b-3eda4ceda380,36586021,4636,841,607,234,14,241
126,ad874a06-052e-4706-855b-3eda4ceda380,36586021,4636,850,845,5,15,241
126,ad874a06-052e-4706-855b-3eda4ceda380,36586021,4636,1250,855,395,35,241
126,ad874a06-052e-4706-855b-3eda4ceda380,36586021,4636,1263,1251,12,39,241
126,ad874a06-052e-4706-855b-3eda4ceda380,36586021,4636,1353,1265,88,40,241
126,ad874a06-052e-4706-855b-3eda4ceda380,36586021,4636,1474,1359,115,41,241
126,ad874a06-052e-4706-855b-3eda4ceda380,36586021,4636,1729,1476,253,50,241
126,ad874a06-052e-4706-855b-3eda4ceda380,36586021,4636,2204,1751,453,51,241
126,ad874a06-052e-4706-855b-3eda4ceda380,36586021,4636,2521,2260,261,181,241
126,ad874a06-052e-4706-855b-3eda4ceda380,36586021,4636,2601,2540,61,182,241
126,ad874a06-052e-4706-855b-3eda4ceda380,36586021,4636,3157,2626,531,241,241
126,ad874a06-052e-4706-855b-3eda4ceda380,36579125,4620,480,4,476,0,98
126,ad874a06-052e-4706-855b-3eda4ceda380,36579125,4620,511,480,31,5,98
126,ad874a06-052e-4706-855b-3eda4ceda380,36579125,4620,771,523,248,6,98
126,ad874a06-052e-4706-855b-3eda4ceda380,36579125,4620,825,774,51,9,98
126,ad874a06-052e-4706-855b-3eda4ceda380,36579125,4620,957,828,129,10,98
126,ad874a06-052e-4706-855b-3eda4ceda380,36579125,4620,1511,971,540,20,98
126,ad874a06-052e-4706-855b-3eda4ceda380,36579125,4620,1530,1518,12,21,98
126,ad874a06-052e-4706-855b-3eda4ceda380,36579125,4620,1864,1550,314,33,98
126,ad874a06-052e-4706-855b-3eda4ceda380,36579125,4620,1984,1870,114,50,98
126,ad874a06-052e-4706-855b-3eda4ceda380,36579125,4620,2262,2047,215,58,98
126,ad874a06-052e-4706-855b-3eda4ceda380,36579125,4620,2299,2269,30,59,98
126,ad874a06-052e-4706-855b-3eda4ceda380,36579125,4620,2703,2307,396,62,98
126,ad874a06-052e-4706-855b-3eda4ceda380,36579125,4620,2859,2704,155,72,98
126,ad874a06-052e-4706-855b-3eda4ceda380,36579125,4620,2853,2748,-105,78,98
126,ad874a06-052e-4706-855b-3eda4ceda380,36579125,4620,2746,2744,-2,79,98
126,ad874a06-052e-4706-855b-3eda4ceda380,36579125,4620,2825,2750,75,89,98
126,ad874a06-052e-4706-855b-3eda4ceda380,36579125,4620,3008,2826,182,90,98
126,ad874a06-052e-4706-855b-3eda4ceda380,36579125,4620,3042,3011,31,91,98
126,ad874a06-052e-4706-855b-3eda4ceda380,36579125,4620,3257,3048,209,93,98
126,ad874a06-052e-4706-855b-3eda4ceda380,36579125,4620,3316,3260,56,94,98
126,ad874a06-052e-4706-855b-3eda4ceda380,36579125,4620,3510,3323,187,98,98
127,c5e70f4c-d511-4e21-9ebb-c9d3c68d158e,36596070,3566,508,11,497,0,19
127,c5e70f4c-d511-4e21-9ebb-c9d3c68d158e,36596070,3566,604,520,84,1,19
127,c5e70f4c-d511-4e21-9ebb-c9d3c68d158e,36596070,3566,715,605,110,2,19
127,c5e70f4c-d511-4e21-9ebb-c9d3c68d158e,36596070,3566,881,720,161,3,19
127,c5e70f4c-d511-4e21-9ebb-c9d3c68d158e,36596070,3566,914,682,-232,4,19
127,c5e70f4c-d511-4e21-9ebb-c9d3c68d158e,36596070,3566,708,684,24,5,19
127,c5e70f4c-d511-4e21-9ebb-c9d3c68d158e,36596070,3566,794,709,85,6,19
127,c5e70f4c-d511-4e21-9ebb-c9d3c68d158e,36596070,3566,886,795,91,7,19
127,c5e70f4c-d511-4e21-9ebb-c9d3c68d158e,36596070,3566,1112,893,219,8,19
127,c5e70f4c-d511-4e21-9ebb-c9d3c68d158e,36596070,3566,1350,1117,233,16,19
127,c5e70f4c-d511-4e21-9ebb-c9d3c68d158e,36596070,3566,1526,1357,169,17,19
127,c5e70f4c-d511-4e21-9ebb-c9d3c68d158e,36596070,3566,1744,1536,208,18,19
127,c5e70f4c-d511-4e21-9ebb-c9d3c68d158e,36596070,3566,1993,1752,241,19,19
8,8075680f-9be7-4982-a8df-07f3cb63d8ed,36594834,8446,1866,50,1816,0,1
8,8075680f-9be7-4982-a8df-07f3cb63d8ed,36594834,8446,1903,1867,36,1,1
24,ee518215-0c04-4b3d-9a94-dd5afd974d1e,36594705,3034,245,1,244,0,4
24,ee518215-0c04-4b3d-9a94-dd5afd974d1e,36594705,3034,655,249,406,1,4
24,ee518215-0c04-4b3d-9a94-dd5afd974d1e,36594705,3034,675,656,19,2,4
24,ee518215-0c04-4b3d-9a94-dd5afd974d1e,36594705,3034,912,711,201,3,4
24,ee518215-0c04-4b3d-9a94-dd5afd974d1e,36594705,3034,2020,943,1077,4,4
124,a3ba2439-7ef5-4e24-a15f-7b8e007cdd8a,36598140,7236,466,8,458,0,11
124,a3ba2439-7ef5-4e24-a15f-7b8e007cdd8a,36598140,7236,1455,513,942,1,11
124,a3ba2439-7ef5-4e24-a15f-7b8e007cdd8a,36598140,7236,1871,1457,414,2,11
124,a3ba2439-7ef5-4e24-a15f-7b8e007cdd8a,36598140,7236,3093,1880,1213,3,11
124,a3ba2439-7ef5-4e24-a15f-7b8e007cdd8a,36598140,7236,3673,3142,531,4,11
124,a3ba2439-7ef5-4e24-a15f-7b8e007cdd8a,36598140,7236,5663,3272,2391,5,11
124,a3ba2439-7ef5-4e24-a15f-7b8e007cdd8a,36598140,7236,5659,3534,-2125,6,11
124,a3ba2439-7ef5-4e24-a15f-7b8e007cdd8a,36598140,7236,3507,2963,-544,7,11
124,a3ba2439-7ef5-4e24-a15f-7b8e007cdd8a,36598140,7236,2952,1874,-1078,8,11
124,a3ba2439-7ef5-4e24-a15f-7b8e007cdd8a,36598140,7236,1865,1578,-287,9,11
124,a3ba2439-7ef5-4e24-a15f-7b8e007cdd8a,36598140,7236,1573,227,-1346,10,11
124,a3ba2439-7ef5-4e24-a15f-7b8e007cdd8a,36598140,7236,219,0,-219,11,11
125,0cc521c3-db3d-410e-9005-4ce578242622,36602509,1675,108,5,103,0,6
125,0cc521c3-db3d-410e-9005-4ce578242622,36602509,1675,141,110,31,1,6
125,0cc521c3-db3d-410e-9005-4ce578242622,36602509,1675,140,0,-140,2,6
125,0cc521c3-db3d-410e-9005-4ce578242622,36602509,1675,17,3,14,4,6
125,0cc521c3-db3d-410e-9005-4ce578242622,36602509,1675,321,19,302,5,6
125,0cc521c3-db3d-410e-9005-4ce578242622,36602509,1675,508,330,178,6,6
125,0cc521c3-db3d-410e-9005-4ce578242622,36592782,5119,298,5,293,0,44
125,0cc521c3-db3d-410e-9005-4ce578242622,36592782,5119,651,307,344,1,44
125,0cc521c3-db3d-410e-9005-4ce578242622,36592782,5119,696,655,41,6,44
125,0cc521c3-db3d-410e-9005-4ce578242622,36592782,5119,797,711,86,7,44
125,0cc521c3-db3d-410e-9005-4ce578242622,36592782,5119,1047,798,249,12,44
125,0cc521c3-db3d-410e-9005-4ce578242622,36592782,5119,1102,1051,51,13,44
125,0cc521c3-db3d-410e-9005-4ce578242622,36592782,5119,1196,1104,92,32,44
125,0cc521c3-db3d-410e-9005-4ce578242622,36592782,5119,1436,1200,236,33,44
125,0cc521c3-db3d-410e-9005-4ce578242622,36592782,5119,1438,1438,0,34,44
125,0cc521c3-db3d-410e-9005-4ce578242622,36592782,5119,1542,1439,103,43,44
125,0cc521c3-db3d-410e-9005-4ce578242622,36592782,5119,1591,1548,43,44,44
125,0cc521c3-db3d-410e-9005-4ce578242622,36599316,1384,203,4,199,0,1
125,0cc521c3-db3d-410e-9005-4ce578242622,36599316,1384,217,206,11,1,1
125,b30cfd40-15dc-428f-8313-7e7b9eda7732,36612368,11463,787,14,773,0,55
125,b30cfd40-15dc-428f-8313-7e7b9eda7732,36612368,11463,1225,806,419,1,55
125,b30cfd40-15dc-428f-8313-7e7b9eda7732,36612368,11463,2020,1409,611,2,55
125,b30cfd40-15dc-428f-8313-7e7b9eda7732,36612368,11463,2191,2026,165,5,55
125,b30cfd40-15dc-428f-8313-7e7b9eda7732,36612368,11463,2402,2204,198,6,55
125,b30cfd40-15dc-428f-8313-7e7b9eda7732,36612368,11463,3220,2673,547,11,55
125,b30cfd40-15dc-428f-8313-7e7b9eda7732,36612368,11463,3671,3229,442,19,55
125,b30cfd40-15dc-428f-8313-7e7b9eda7732,36612368,11463,3679,3672,7,20,55
125,b30cfd40-15dc-428f-8313-7e7b9eda7732,36612368,11463,4241,3684,557,28,55
125,b30cfd40-15dc-428f-8313-7e7b9eda7732,36612368,11463,4246,4246,0,39,55
125,b30cfd40-15dc-428f-8313-7e7b9eda7732,36612368,11463,5102,4292,810,40,55
125,b30cfd40-15dc-428f-8313-7e7b9eda7732,36612368,11463,5613,4990,623,41,55
125,b30cfd40-15dc-428f-8313-7e7b9eda7732,36612368,11463,6594,5631,963,42,55
125,b30cfd40-15dc-428f-8313-7e7b9eda7732,36612368,11463,6848,6618,230,43,55
125,b30cfd40-15dc-428f-8313-7e7b9eda7732,36612368,11463,6938,6893,45,47,55
125,b30cfd40-15dc-428f-8313-7e7b9eda7732,36612368,11463,7277,6974,303,48,55
125,b30cfd40-15dc-428f-8313-7e7b9eda7732,36612368,11463,7567,7279,288,49,55
125,b30cfd40-15dc-428f-8313-7e7b9eda7732,36612368,11463,8842,7585,1257,54,55
125,b30cfd40-15dc-428f-8313-7e7b9eda7732,36612368,11463,9439,8886,553,55,55
125,f550babb-7286-496b-8fa3-3f082357ae72,36621030,12174,536,18,518,0,27
125,f550babb-7286-496b-8fa3-3f082357ae72,36621030,12174,422,319,-103,1,27
125,f550babb-7286-496b-8fa3-3f082357ae72,36621030,12174,522,379,143,2,27
125,f550babb-7286-496b-8fa3-3f082357ae72,36621030,12174,632,542,90,4,27
125,f550babb-7286-496b-8fa3-3f082357ae72,36621030,12174,1861,700,1161,5,27
125,f550babb-7286-496b-8fa3-3f082357ae72,36621030,12174,1862,1862,0,6,27
125,f550babb-7286-496b-8fa3-3f082357ae72,36621030,12174,2665,1865,800,11,27
125,f550babb-7286-496b-8fa3-3f082357ae72,36621030,12174,3292,2668,624,26,27
125,f550babb-7286-496b-8fa3-3f082357ae72,36621030,12174,3717,3329,388,27,27
133,a86020c1-5d8a-43ef-aa11-402a1998a73f,36615028,11130,184,8,176,0,16
133,a86020c1-5d8a-43ef-aa11-402a1998a73f,36615028,11130,103,35,68,1,16
133,a86020c1-5d8a-43ef-aa11-402a1998a73f,36615028,11130,761,128,633,13,16
133,a86020c1-5d8a-43ef-aa11-402a1998a73f,36615028,11130,1303,775,528,14,16
133,a86020c1-5d8a-43ef-aa11-402a1998a73f,36615028,11130,3626,1318,2308,15,16
133,a86020c1-5d8a-43ef-aa11-402a1998a73f,36615028,11130,3809,3642,167,16,16
133,5a7532ef-59e6-4290-b067-5f96e61b07f1,36608269,2838,135,6,129,0,33
133,5a7532ef-59e6-4290-b067-5f96e61b07f1,36608269,2838,420,34,-386,1,33
133,5a7532ef-59e6-4290-b067-5f96e61b07f1,36608269,2838,47,0,47,2,33
133,5a7532ef-59e6-4290-b067-5f96e61b07f1,36608269,2838,246,55,191,3,33
133,5a7532ef-59e6-4290-b067-5f96e61b07f1,36608269,2838,407,270,137,4,33
133,5a7532ef-59e6-4290-b067-5f96e61b07f1,36608269,2838,644,416,228,9,33
133,5a7532ef-59e6-4290-b067-5f96e61b07f1,36608269,2838,949,648,301,17,33
133,5a7532ef-59e6-4290-b067-5f96e61b07f1,36608269,2838,1074,967,107,23,33
133,5a7532ef-59e6-4290-b067-5f96e61b07f1,36608269,2838,1195,1094,101,24,33
133,5a7532ef-59e6-4290-b067-5f96e61b07f1,36608269,2838,1448,1198,250,28,33
133,5a7532ef-59e6-4290-b067-5f96e61b07f1,36608269,2838,1728,1471,257,33,33
133,5a7532ef-59e6-4290-b067-5f96e61b07f1,36574299,2642,198,3,195,0,24
133,5a7532ef-59e6-4290-b067-5f96e61b07f1,36574299,2642,305,209,96,1,24
133,5a7532ef-59e6-4290-b067-5f96e61b07f1,36574299,2642,640,314,326,5,24
133,5a7532ef-59e6-4290-b067-5f96e61b07f1,36574299,2642,801,641,160,8,24
133,5a7532ef-59e6-4290-b067-5f96e61b07f1,36574299,2642,961,820,141,9,24
133,5a7532ef-59e6-4290-b067-5f96e61b07f1,36574299,2642,1235,971,264,12,24
133,5a7532ef-59e6-4290-b067-5f96e61b07f1,36574299,2642,1255,1238,17,13,24
133,5a7532ef-59e6-4290-b067-5f96e61b07f1,36574299,2642,1532,1265,267,24,24
8,ce86df48-ad19-478b-a037-d390d52e6ed7,36647032,5598,131,6,125,0,22
8,ce86df48-ad19-478b-a037-d390d52e6ed7,36647032,5598,305,134,171,1,22
8,ce86df48-ad19-478b-a037-d390d52e6ed7,36647032,5598,483,321,162,2,22
8,ce86df48-ad19-478b-a037-d390d52e6ed7,36647032,5598,642,492,150,3,22
8,ce86df48-ad19-478b-a037-d390d52e6ed7,36647032,5598,832,644,188,4,22
8,ce86df48-ad19-478b-a037-d390d52e6ed7,36647032,5598,841,836,5,5,22
8,ce86df48-ad19-478b-a037-d390d52e6ed7,36647032,5598,910,851,59,9,22
8,ce86df48-ad19-478b-a037-d390d52e6ed7,36647032,5598,967,920,47,10,22
8,ce86df48-ad19-478b-a037-d390d52e6ed7,36647032,5598,1029,977,52,11,22
8,ce86df48-ad19-478b-a037-d390d52e6ed7,36647032,5598,1086,1035,51,12,22
8,ce86df48-ad19-478b-a037-d390d52e6ed7,36647032,5598,1141,1089,52,17,22
8,ce86df48-ad19-478b-a037-d390d52e6ed7,36647032,5598,1186,1147,39,18,22
8,ce86df48-ad19-478b-a037-d390d52e6ed7,36647032,5598,1273,1192,81,19,22
8,ce86df48-ad19-478b-a037-d390d52e6ed7,36647032,5598,1417,1289,128,20,22
8,ce86df48-ad19-478b-a037-d390d52e6ed7,36647032,5598,1569,1425,144,21,22
8,ce86df48-ad19-478b-a037-d390d52e6ed7,36647032,5598,1658,1573,85,22,22
8,ce86df48-ad19-478b-a037-d390d52e6ed7,36637591,10687,37,2,35,0,45
8,ce86df48-ad19-478b-a037-d390d52e6ed7,36637591,10687,219,49,170,1,45
8,ce86df48-ad19-478b-a037-d390d52e6ed7,36637591,10687,281,224,57,2,45
8,ce86df48-ad19-478b-a037-d390d52e6ed7,36637591,10687,414,282,132,3,45
8,ce86df48-ad19-478b-a037-d390d52e6ed7,36637591,10687,499,420,79,4,45
8,ce86df48-ad19-478b-a037-d390d52e6ed7,36637591,10687,569,507,62,5,45
8,ce86df48-ad19-478b-a037-d390d52e6ed7,36637591,10687,640,576,64,6,45
8,ce86df48-ad19-478b-a037-d390d52e6ed7,36637591,10687,669,641,28,7,45
8,ce86df48-ad19-478b-a037-d390d52e6ed7,36637591,10687,754,670,84,13,45
8,ce86df48-ad19-478b-a037-d390d52e6ed7,36637591,10687,804,759,45,14,45
8,ce86df48-ad19-478b-a037-d390d52e6ed7,36637591,10687,860,812,48,15,45
8,ce86df48-ad19-478b-a037-d390d52e6ed7,36637591,10687,983,865,118,40,45
8,ce86df48-ad19-478b-a037-d390d52e6ed7,36637591,10687,1025,985,40,41,45
8,ce86df48-ad19-478b-a037-d390d52e6ed7,36637591,10687,1119,1033,86,42,45
8,ce86df48-ad19-478b-a037-d390d52e6ed7,36637591,10687,1204,1126,78,43,45
8,ce86df48-ad19-478b-a037-d390d52e6ed7,36637591,10687,1311,1207,104,45,45
8,fe5b5a01-3418-4a75-bb52-6178ab712af4,36642667,5881,159,14,145,0,10
8,fe5b5a01-3418-4a75-bb52-6178ab712af4,36642667,5881,517,181,336,1,10
8,fe5b5a01-3418-4a75-bb52-6178ab712af4,36642667,5881,1390,557,833,2,10
8,fe5b5a01-3418-4a75-bb52-6178ab712af4,36642667,5881,2515,1443,1072,3,10
8,fe5b5a01-3418-4a75-bb52-6178ab712af4,36642667,5881,2913,2535,378,4,10
8,fe5b5a01-3418-4a75-bb52-6178ab712af4,36642667,5881,3424,2943,481,5,10
8,fe5b5a01-3418-4a75-bb52-6178ab712af4,36642667,5881,4159,3457,702,6,10
8,fe5b5a01-3418-4a75-bb52-6178ab712af4,36642667,5881,4308,4203,105,7,10
8,fe5b5a01-3418-4a75-bb52-6178ab712af4,36642667,5881,4301,4097,-204,8,10
8,fe5b5a01-3418-4a75-bb52-6178ab712af4,36642667,5881,4075,1272,-2803,9,10
8,fe5b5a01-3418-4a75-bb52-6178ab712af4,36642667,5881,1212,354,-858,10,10
8,c6b0ebc3-ccd4-42df-ae56-23e7726f853e,36626454,3269,474,9,465,0,11
8,c6b0ebc3-ccd4-42df-ae56-23e7726f853e,36626454,3269,586,481,105,1,11
8,c6b0ebc3-ccd4-42df-ae56-23e7726f853e,36626454,3269,738,597,141,2,11
8,c6b0ebc3-ccd4-42df-ae56-23e7726f853e,36626454,3269,834,741,93,6,11
8,c6b0ebc3-ccd4-42df-ae56-23e7726f853e,36626454,3269,915,844,71,7,11
8,c6b0ebc3-ccd4-42df-ae56-23e7726f853e,36626454,3269,908,871,-37,8,11
8,c6b0ebc3-ccd4-42df-ae56-23e7726f853e,36626454,3269,859,782,-77,9,11
8,c6b0ebc3-ccd4-42df-ae56-23e7726f853e,36626454,3269,1067,824,243,10,11
8,c6b0ebc3-ccd4-42df-ae56-23e7726f853e,36626454,3269,1696,1080,616,11,11
8,4936cbd5-55e6-4d3e-8735-5e3cb1886bac,36644934,6259,3804,14,3790,0,6
8,4936cbd5-55e6-4d3e-8735-5e3cb1886bac,36644934,6259,4686,3921,765,1,6
8,4936cbd5-55e6-4d3e-8735-5e3cb1886bac,36644934,6259,4592,0,-4592,2,6
8,4936cbd5-55e6-4d3e-8735-5e3cb1886bac,36644934,6259,1081,46,1035,3,6
8,4936cbd5-55e6-4d3e-8735-5e3cb1886bac,36644934,6259,1463,1090,373,4,6
8,4936cbd5-55e6-4d3e-8735-5e3cb1886bac,36644934,6259,1841,1477,364,5,6
8,4936cbd5-55e6-4d3e-8735-5e3cb1886bac,36644934,6259,2218,1877,341,6,6
125,0eeea390-08a6-4f1b-bfd5-0f0e63a984de,36640464,3273,712,23,689,0,52
125,0eeea390-08a6-4f1b-bfd5-0f0e63a984de,36640464,3273,967,751,216,1,52
125,0eeea390-08a6-4f1b-bfd5-0f0e63a984de,36640464,3273,1608,978,630,16,52
125,0eeea390-08a6-4f1b-bfd5-0f0e63a984de,36640464,3273,1608,1607,1,18,52
125,0eeea390-08a6-4f1b-bfd5-0f0e63a984de,36640464,3273,1608,1607,-1,18,52
125,0eeea390-08a6-4f1b-bfd5-0f0e63a984de,36640464,3273,1608,1442,-166,19,52
125,0eeea390-08a6-4f1b-bfd5-0f0e63a984de,36640464,3273,1608,1444,164,20,52
125,0eeea390-08a6-4f1b-bfd5-0f0e63a984de,36640464,3273,1599,1272,-327,51,52
125,0eeea390-08a6-4f1b-bfd5-0f0e63a984de,36640464,3273,1227,108,-1119,52,52
125,0eeea390-08a6-4f1b-bfd5-0f0e63a984de,36638178,5577,1042,20,1022,0,27
125,0eeea390-08a6-4f1b-bfd5-0f0e63a984de,36638178,5577,1079,1052,27,1,27
125,0eeea390-08a6-4f1b-bfd5-0f0e63a984de,36638178,5577,1101,1101,0,8,27
125,0eeea390-08a6-4f1b-bfd5-0f0e63a984de,36638178,5577,1621,1126,495,9,27
125,0eeea390-08a6-4f1b-bfd5-0f0e63a984de,36638178,5577,1624,1623,1,10,27
125,0eeea390-08a6-4f1b-bfd5-0f0e63a984de,36638178,5577,3666,1669,1997,21,27
125,0eeea390-08a6-4f1b-bfd5-0f0e63a984de,36638178,5577,3912,3745,167,22,27
125,0eeea390-08a6-4f1b-bfd5-0f0e63a984de,36638178,5577,3887,2966,-921,24,27
125,0eeea390-08a6-4f1b-bfd5-0f0e63a984de,36638178,5577,3450,3025,425,26,27
125,0eeea390-08a6-4f1b-bfd5-0f0e63a984de,36638178,5577,3534,3453,81,27,27
125,37c6d71b-7c08-4a97-9995-695f9f9b928e,36659894,2493,255,19,236,0,22
125,37c6d71b-7c08-4a97-9995-695f9f9b928e,36659894,2493,828,261,567,1,22
125,37c6d71b-7c08-4a97-9995-695f9f9b928e,36659894,2493,828,41,787,22,22
250,bc43f889-0333-48d8-b17e-3918ca1e1ef8,36659900,12480,534,11,523,0,16
250,bc43f889-0333-48d8-b17e-3918ca1e1ef8,36659900,12480,540,537,3,1,16
250,bc43f889-0333-48d8-b17e-3918ca1e1ef8,36659900,12480,1188,559,629,3,16
250,bc43f889-0333-48d8-b17e-3918ca1e1ef8,36659900,12480,1532,1200,332,5,16
250,bc43f889-0333-48d8-b17e-3918ca1e1ef8,36659900,12480,1531,479,-1052,6,16
250,bc43f889-0333-48d8-b17e-3918ca1e1ef8,36659900,12480,800,508,292,7,16
250,bc43f889-0333-48d8-b17e-3918ca1e1ef8,36659900,12480,809,801,8,8,16
250,bc43f889-0333-48d8-b17e-3918ca1e1ef8,36659900,12480,1544,873,671,15,16
250,bc43f889-0333-48d8-b17e-3918ca1e1ef8,36659900,12480,2935,1644,1291,16,16
250,bc43f889-0333-48d8-b17e-3918ca1e1ef8,36645822,7698,421,19,402,0,24
250,bc43f889-0333-48d8-b17e-3918ca1e1ef8,36645822,7698,410,297,-113,5,24
250,bc43f889-0333-48d8-b17e-3918ca1e1ef8,36645822,7698,259,0,-259,6,24
250,bc43f889-0333-48d8-b17e-3918ca1e1ef8,36645822,7698,1509,1,1508,7,24
250,bc43f889-0333-48d8-b17e-3918ca1e1ef8,36645822,7698,1955,1555,400,9,24
250,bc43f889-0333-48d8-b17e-3918ca1e1ef8,36645822,7698,2834,1987,847,10,24
250,bc43f889-0333-48d8-b17e-3918ca1e1ef8,36645822,7698,2925,2846,79,11,24
250,bc43f889-0333-48d8-b17e-3918ca1e1ef8,36645822,7698,3419,2960,459,15,24
250,bc43f889-0333-48d8-b17e-3918ca1e1ef8,36645822,7698,3933,3473,460,16,24
250,bc43f889-0333-48d8-b17e-3918ca1e1ef8,36645822,7698,4882,3948,934,18,24
250,bc43f889-0333-48d8-b17e-3918ca1e1ef8,36645822,7698,5088,4904,184,19,24
250,bc43f889-0333-48d8-b17e-3918ca1e1ef8,36645822,7698,5646,5099,547,24,24
250,bc43f889-0333-48d8-b17e-3918ca1e1ef8,36662636,5694,161,11,150,0,19
250,bc43f889-0333-48d8-b17e-3918ca1e1ef8,36662636,5694,410,191,219,1,19
250,bc43f889-0333-48d8-b17e-3918ca1e1ef8,36662636,5694,848,415,433,2,19
250,bc43f889-0333-48d8-b17e-3918ca1e1ef8,36662636,5694,1201,851,350,4,19
250,bc43f889-0333-48d8-b17e-3918ca1e1ef8,36662636,5694,1296,1207,89,6,19
250,bc43f889-0333-48d8-b17e-3918ca1e1ef8,36662636,5694,1693,1335,358,7,19
250,bc43f889-0333-48d8-b17e-3918ca1e1ef8,36662636,5694,2696,1726,970,9,19
250,bc43f889-0333-48d8-b17e-3918ca1e1ef8,36662636,5694,3516,2721,795,10,19
250,bc43f889-0333-48d8-b17e-3918ca1e1ef8,36662636,5694,3677,3543,134,11,19
250,bc43f889-0333-48d8-b17e-3918ca1e1ef8,36662636,5694,3544,0,-3544,12,19
250,bc43f889-0333-48d8-b17e-3918ca1e1ef8,36662636,5694,1552,113,1439,14,19
250,bc43f889-0333-48d8-b17e-3918ca1e1ef8,36662636,5694,3561,1742,1819,15,19
250,bc43f889-0333-48d8-b17e-3918ca1e1ef8,36662636,5694,4029,3582,447,16,19
250,bc43f889-0333-48d8-b17e-3918ca1e1ef8,36662636,5694,3916,1782,-2134,17,19
250,bc43f889-0333-48d8-b17e-3918ca1e1ef8,36662636,5694,1761,1609,-152,18,19
250,bc43f889-0333-48d8-b17e-3918ca1e1ef8,36662636,5694,1533,753,-780,19,19
251,a5c9e301-b855-4584-9328-27c0040194b5,36663181,7196,190,5,185,0,24
251,a5c9e301-b855-4584-9328-27c0040194b5,36663181,7196,540,196,344,1,24
251,a5c9e301-b855-4584-9328-27c0040194b5,36663181,7196,833,551,282,2,24
251,a5c9e301-b855-4584-9328-27c0040194b5,36663181,7196,887,847,40,3,24
251,a5c9e301-b855-4584-9328-27c0040194b5,36663181,7196,1035,893,142,8,24
251,a5c9e301-b855-4584-9328-27c0040194b5,36663181,7196,2174,1060,1114,9,24
251,a5c9e301-b855-4584-9328-27c0040194b5,36663181,7196,2183,2177,6,10,24
251,a5c9e301-b855-4584-9328-27c0040194b5,36663181,7196,2683,2228,455,11,24
251,a5c9e301-b855-4584-9328-27c0040194b5,36663181,7196,3933,2711,1222,12,24
251,a5c9e301-b855-4584-9328-27c0040194b5,36663181,7196,4066,3949,117,13,24
251,a5c9e301-b855-4584-9328-27c0040194b5,36663181,7196,3954,3427,-527,14,24
251,a5c9e301-b855-4584-9328-27c0040194b5,36663181,7196,3605,3439,166,23,24
251,a5c9e301-b855-4584-9328-27c0040194b5,36663181,7196,4972,3611,1361,24,24
126,51948097-a988-43db-820e-ed4b05e21f44,36663127,3458,126,6,120,0,61
126,51948097-a988-43db-820e-ed4b05e21f44,36663127,3458,483,185,298,1,61
126,51948097-a988-43db-820e-ed4b05e21f44,36663127,3458,963,491,472,23,61
126,51948097-a988-43db-820e-ed4b05e21f44,36663127,3458,1104,966,138,31,61
126,51948097-a988-43db-820e-ed4b05e21f44,36663127,3458,1234,1107,127,32,61
126,51948097-a988-43db-820e-ed4b05e21f44,36663127,3458,1796,1248,548,34,61
126,51948097-a988-43db-820e-ed4b05e21f44,36663127,3458,2015,1800,215,35,61
126,51948097-a988-43db-820e-ed4b05e21f44,36663127,3458,2270,2027,243,36,61
126,51948097-a988-43db-820e-ed4b05e21f44,36663127,3458,2348,2275,73,40,61
126,51948097-a988-43db-820e-ed4b05e21f44,36663127,3458,2330,2118,-212,50,61
126,51948097-a988-43db-820e-ed4b05e21f44,36663127,3458,2102,1287,-815,51,61
126,51948097-a988-43db-820e-ed4b05e21f44,36663127,3458,1286,1285,-1,52,61
126,51948097-a988-43db-820e-ed4b05e21f44,36663127,3458,1260,884,-376,56,61
126,51948097-a988-43db-820e-ed4b05e21f44,36663127,3458,868,850,-18,57,61
126,51948097-a988-43db-820e-ed4b05e21f44,36663127,3458,831,276,-555,58,61
126,51948097-a988-43db-820e-ed4b05e21f44,36663127,3458,371,277,94,60,61
126,51948097-a988-43db-820e-ed4b05e21f44,36663127,3458,372,372,0,61,61
133,4bf13806-3d36-403d-be06-48373c6e0f0c,36662684,10372,398,9,389,0,84
133,4bf13806-3d36-403d-be06-48373c6e0f0c,36662684,10372,868,413,455,3,84
133,4bf13806-3d36-403d-be06-48373c6e0f0c,36662684,10372,879,871,8,4,84
133,4bf13806-3d36-403d-be06-48373c6e0f0c,36662684,10372,1409,884,525,12,84
133,4bf13806-3d36-403d-be06-48373c6e0f0c,36662684,10372,2039,1412,627,16,84
133,4bf13806-3d36-403d-be06-48373c6e0f0c,36662684,10372,2539,2046,493,17,84
133,4bf13806-3d36-403d-be06-48373c6e0f0c,36662684,10372,2552,2542,10,18,84
133,4bf13806-3d36-403d-be06-48373c6e0f0c,36662684,10372,2982,2560,422,20,84
133,4bf13806-3d36-403d-be06-48373c6e0f0c,36662684,10372,3047,2987,60,21,84
133,4bf13806-3d36-403d-be06-48373c6e0f0c,36662684,10372,3774,3072,702,79,84
133,4bf13806-3d36-403d-be06-48373c6e0f0c,36662684,10372,4569,3776,793,80,84
133,4bf13806-3d36-403d-be06-48373c6e0f0c,36662684,10372,5820,4637,1183,81,84
133,4bf13806-3d36-403d-be06-48373c6e0f0c,36662684,10372,7018,5843,1175,82,84
133,4bf13806-3d36-403d-be06-48373c6e0f0c,36662684,10372,7882,7057,825,83,84
133,4bf13806-3d36-403d-be06-48373c6e0f0c,36662684,10372,8506,7883,623,84,84
133,4bf13806-3d36-403d-be06-48373c6e0f0c,36638178,3718,256,8,248,0,20
133,4bf13806-3d36-403d-be06-48373c6e0f0c,36638178,3718,289,262,27,1,20
133,4bf13806-3d36-403d-be06-48373c6e0f0c,36638178,3718,667,291,376,7,20
133,4bf13806-3d36-403d-be06-48373c6e0f0c,36638178,3718,773,678,95,9,20
133,4bf13806-3d36-403d-be06-48373c6e0f0c,36638178,3718,1085,795,290,10,20
133,4bf13806-3d36-403d-be06-48373c6e0f0c,36638178,3718,1171,1096,75,13,20
133,4bf13806-3d36-403d-be06-48373c6e0f0c,36638178,3718,1455,1191,264,14,20
133,4bf13806-3d36-403d-be06-48373c6e0f0c,36638178,3718,1974,1458,516,17,20
133,4bf13806-3d36-403d-be06-48373c6e0f0c,36638178,3718,2448,1981,467,19,20
133,4bf13806-3d36-403d-be06-48373c6e0f0c,36638178,3718,2608,2453,155,20,20
251,fb1b1b64-97d7-454a-82ef-5f39244c37ce,36660133,10388,479,10,469,0,2
251,fb1b1b64-97d7-454a-82ef-5f39244c37ce,36660133,10388,739,492,247,2,2
133,4bf13806-3d36-403d-be06-48373c6e0f0c,36661402,2188,378,12,366,0,14
133,4bf13806-3d36-403d-be06-48373c6e0f0c,36661402,2188,421,386,35,1,14
133,4bf13806-3d36-403d-be06-48373c6e0f0c,36661402,2188,808,436,372,3,14
133,4bf13806-3d36-403d-be06-48373c6e0f0c,36661402,2188,1078,813,265,6,14
133,4bf13806-3d36-403d-be06-48373c6e0f0c,36661402,2188,1041,319,-722,8,14
133,4bf13806-3d36-403d-be06-48373c6e0f0c,36661402,2188,184,0,-184,9,14
133,4bf13806-3d36-403d-be06-48373c6e0f0c,36661402,2188,1078,32,1046,11,14
133,4bf13806-3d36-403d-be06-48373c6e0f0c,36661402,2188,1035,0,-1035,12,14
133,4bf13806-3d36-403d-be06-48373c6e0f0c,36661402,2188,1078,28,1050,13,14
133,4bf13806-3d36-403d-be06-48373c6e0f0c,36661402,2188,1078,0,1078,14,14
251,7c59963a-ef76-4750-ad09-e0558f1dea09,36669137,4028,207,5,202,0,15
251,7c59963a-ef76-4750-ad09-e0558f1dea09,36669137,4028,213,0,-213,1,15
251,7c59963a-ef76-4750-ad09-e0558f1dea09,36669137,4028,366,9,357,4,15
251,7c59963a-ef76-4750-ad09-e0558f1dea09,36669137,4028,897,381,516,5,15
251,7c59963a-ef76-4750-ad09-e0558f1dea09,36669137,4028,1185,910,275,6,15
251,7c59963a-ef76-4750-ad09-e0558f1dea09,36669137,4028,1261,1189,72,9,15
251,7c59963a-ef76-4750-ad09-e0558f1dea09,36669137,4028,1605,1272,333,10,15
251,7c59963a-ef76-4750-ad09-e0558f1dea09,36669137,4028,1630,1613,17,11,15
251,7c59963a-ef76-4750-ad09-e0558f1dea09,36669137,4028,1804,1638,166,15,15
251,7c59963a-ef76-4750-ad09-e0558f1dea09,36662592,6384,71,13,58,0,46
251,7c59963a-ef76-4750-ad09-e0558f1dea09,36662592,6384,585,91,494,1,46
251,7c59963a-ef76-4750-ad09-e0558f1dea09,36662592,6384,915,591,324,2,46
251,7c59963a-ef76-4750-ad09-e0558f1dea09,36662592,6384,961,918,43,3,46
251,7c59963a-ef76-4750-ad09-e0558f1dea09,36662592,6384,1174,965,209,6,46
251,7c59963a-ef76-4750-ad09-e0558f1dea09,36662592,6384,1204,1185,19,7,46
251,7c59963a-ef76-4750-ad09-e0558f1dea09,36662592,6384,1358,1205,153,9,46
251,7c59963a-ef76-4750-ad09-e0558f1dea09,36662592,6384,1480,1363,117,10,46
251,7c59963a-ef76-4750-ad09-e0558f1dea09,36662592,6384,1669,1485,184,13,46
251,7c59963a-ef76-4750-ad09-e0558f1dea09,36662592,6384,1870,1678,192,14,46
251,7c59963a-ef76-4750-ad09-e0558f1dea09,36662592,6384,2041,1872,169,17,46
251,7c59963a-ef76-4750-ad09-e0558f1dea09,36662592,6384,2171,2043,128,18,46
251,7c59963a-ef76-4750-ad09-e0558f1dea09,36662592,6384,2422,2183,239,19,46
251,7c59963a-ef76-4750-ad09-e0558f1dea09,36662592,6384,2618,2427,191,22,46
251,7c59963a-ef76-4750-ad09-e0558f1dea09,36662592,6384,2629,2622,7,23,46
251,7c59963a-ef76-4750-ad09-e0558f1dea09,36662592,6384,2760,2637,123,25,46
251,7c59963a-ef76-4750-ad09-e0558f1dea09,36662592,6384,2821,2763,58,26,46
251,7c59963a-ef76-4750-ad09-e0558f1dea09,36662592,6384,2822,2822,0,27,46
251,7c59963a-ef76-4750-ad09-e0558f1dea09,36662592,6384,3020,2824,196,31,46
251,7c59963a-ef76-4750-ad09-e0558f1dea09,36662592,6384,3095,3024,71,32,46
251,7c59963a-ef76-4750-ad09-e0558f1dea09,36662592,6384,3299,3104,195,43,46
251,7c59963a-ef76-4750-ad09-e0558f1dea09,36662592,6384,3317,3308,9,44,46
251,7c59963a-ef76-4750-ad09-e0558f1dea09,36662592,6384,3509,3325,184,46,46
130,1f4d5c38-84d1-4644-99f7-b3876d866ef4,36671336,1611,87,8,79,0,2
130,1f4d5c38-84d1-4644-99f7-b3876d866ef4,36671336,1611,57,0,-57,2,2
127,a2880231-3c28-4abd-9ce6-2fa4342203d9,36672001,3553,129,3,126,0,52
127,a2880231-3c28-4abd-9ce6-2fa4342203d9,36672001,3553,235,132,103,1,52
127,a2880231-3c28-4abd-9ce6-2fa4342203d9,36672001,3553,307,245,62,11,52
127,a2880231-3c28-4abd-9ce6-2fa4342203d9,36672001,3553,372,319,53,12,52
127,a2880231-3c28-4abd-9ce6-2fa4342203d9,36672001,3553,568,373,195,19,52
127,a2880231-3c28-4abd-9ce6-2fa4342203d9,36672001,3553,610,576,34,20,52
127,a2880231-3c28-4abd-9ce6-2fa4342203d9,36672001,3553,695,623,72,21,52
127,a2880231-3c28-4abd-9ce6-2fa4342203d9,36672001,3553,955,698,257,28,52
127,a2880231-3c28-4abd-9ce6-2fa4342203d9,36672001,3553,1135,959,176,31,52
127,a2880231-3c28-4abd-9ce6-2fa4342203d9,36672001,3553,1338,1143,195,37,52
127,a2880231-3c28-4abd-9ce6-2fa4342203d9,36672001,3553,1603,1341,262,47,52
127,a2880231-3c28-4abd-9ce6-2fa4342203d9,36672001,3553,1817,1614,203,51,52
127,a2880231-3c28-4abd-9ce6-2fa4342203d9,36672001,3553,1980,1826,154,52,52
250,84f7d78b-767a-4b1d-98e4-dd7d22c26f50,36672591,6948,751,2,749,0,30
250,84f7d78b-767a-4b1d-98e4-dd7d22c26f50,36672591,6948,855,773,82,1,30
250,84f7d78b-767a-4b1d-98e4-dd7d22c26f50,36672591,6948,1066,866,200,11,30
250,84f7d78b-767a-4b1d-98e4-dd7d22c26f50,36672591,6948,1757,1068,689,13,30
250,84f7d78b-767a-4b1d-98e4-dd7d22c26f50,36672591,6948,2390,1741,649,16,30
250,84f7d78b-767a-4b1d-98e4-dd7d22c26f50,36672591,6948,2443,2408,35,17,30
250,84f7d78b-767a-4b1d-98e4-dd7d22c26f50,36672591,6948,2783,2507,276,21,30
250,84f7d78b-767a-4b1d-98e4-dd7d22c26f50,36672591,6948,5283,2788,2495,28,30
250,84f7d78b-767a-4b1d-98e4-dd7d22c26f50,36672591,6948,5202,4612,-590,29,30
250,84f7d78b-767a-4b1d-98e4-dd7d22c26f50,36672591,6948,4406,0,-4406,30,30
250,1dc21c0f-c0d8-4411-ba62-1d1c1f7fc47c,36613679,9375,788,69,719,0,56
250,1dc21c0f-c0d8-4411-ba62-1d1c1f7fc47c,36613679,9375,1544,848,696,1,56
250,1dc21c0f-c0d8-4411-ba62-1d1c1f7fc47c,36613679,9375,1908,1580,328,16,56
250,1dc21c0f-c0d8-4411-ba62-1d1c1f7fc47c,36613679,9375,2156,1948,208,17,56
250,1dc21c0f-c0d8-4411-ba62-1d1c1f7fc47c,36613679,9375,3199,2186,1013,18,56
250,1dc21c0f-c0d8-4411-ba62-1d1c1f7fc47c,36613679,9375,3386,3202,184,35,56
250,1dc21c0f-c0d8-4411-ba62-1d1c1f7fc47c,36613679,9375,3772,3397,375,47,56
250,1dc21c0f-c0d8-4411-ba62-1d1c1f7fc47c,36613679,9375,4200,3779,421,48,56
250,1dc21c0f-c0d8-4411-ba62-1d1c1f7fc47c,36613679,9375,4201,4201,0,49,56
250,1dc21c0f-c0d8-4411-ba62-1d1c1f7fc47c,36613679,9375,4822,4219,603,55,56
250,1dc21c0f-c0d8-4411-ba62-1d1c1f7fc47c,36613679,9375,5214,4849,365,56,56
251,02a76bc1-0d5b-43da-ad5c-f52c8472502c,36677028,8844,299,13,286,0,43
251,02a76bc1-0d5b-43da-ad5c-f52c8472502c,36677028,8844,437,308,129,2,43
251,02a76bc1-0d5b-43da-ad5c-f52c8472502c,36677028,8844,606,440,166,3,43
251,02a76bc1-0d5b-43da-ad5c-f52c8472502c,36677028,8844,792,613,179,8,43
251,02a76bc1-0d5b-43da-ad5c-f52c8472502c,36677028,8844,924,801,123,12,43
251,02a76bc1-0d5b-43da-ad5c-f52c8472502c,36677028,8844,1015,925,90,15,43
251,02a76bc1-0d5b-43da-ad5c-f52c8472502c,36677028,8844,1096,1020,76,16,43
251,02a76bc1-0d5b-43da-ad5c-f52c8472502c,36677028,8844,1208,1101,107,17,43
251,02a76bc1-0d5b-43da-ad5c-f52c8472502c,36677028,8844,1299,1214,85,20,43
251,02a76bc1-0d5b-43da-ad5c-f52c8472502c,36677028,8844,1342,1308,34,21,43
251,02a76bc1-0d5b-43da-ad5c-f52c8472502c,36677028,8844,1390,1349,41,23,43
251,02a76bc1-0d5b-43da-ad5c-f52c8472502c,36677028,8844,1657,1403,254,24,43
251,02a76bc1-0d5b-43da-ad5c-f52c8472502c,36677028,8844,1784,1660,124,26,43
251,02a76bc1-0d5b-43da-ad5c-f52c8472502c,36677028,8844,1823,1790,33,31,43
251,02a76bc1-0d5b-43da-ad5c-f52c8472502c,36677028,8844,1918,1840,78,32,43
251,02a76bc1-0d5b-43da-ad5c-f52c8472502c,36677028,8844,2359,1925,434,34,43
251,02a76bc1-0d5b-43da-ad5c-f52c8472502c,36677028,8844,2529,2364,165,35,43
251,02a76bc1-0d5b-43da-ad5c-f52c8472502c,36677028,8844,2738,2533,205,37,43
251,02a76bc1-0d5b-43da-ad5c-f52c8472502c,36677028,8844,2983,2749,234,38,43
251,02a76bc1-0d5b-43da-ad5c-f52c8472502c,36677028,8844,3201,2985,216,40,43
251,02a76bc1-0d5b-43da-ad5c-f52c8472502c,36677028,8844,3237,3208,29,41,43
251,02a76bc1-0d5b-43da-ad5c-f52c8472502c,36677028,8844,4556,3260,1296,42,43
251,02a76bc1-0d5b-43da-ad5c-f52c8472502c,36677028,8844,6620,4633,1987,43,43
8,3db79b26-5b9f-4e58-97e7-45a8b790b55b,36684452,8367,1047,61,986,0,1
8,3db79b26-5b9f-4e58-97e7-45a8b790b55b,36684452,8367,3256,1147,2109,1,1
251,888e1bbd-ade7-4a31-8b69-76f1014afef9,36613679,26388,487,3,484,0,38
251,888e1bbd-ade7-4a31-8b69-76f1014afef9,36613679,26388,985,538,447,1,38
251,888e1bbd-ade7-4a31-8b69-76f1014afef9,36613679,26388,1157,993,164,5,38
251,888e1bbd-ade7-4a31-8b69-76f1014afef9,36613679,26388,1264,1161,103,6,38
251,888e1bbd-ade7-4a31-8b69-76f1014afef9,36613679,26388,1507,1265,242,8,38
251,888e1bbd-ade7-4a31-8b69-76f1014afef9,36613679,26388,1537,1509,28,9,38
251,888e1bbd-ade7-4a31-8b69-76f1014afef9,36613679,26388,1850,1538,312,20,38
251,888e1bbd-ade7-4a31-8b69-76f1014afef9,36613679,26388,2022,1859,163,21,38
251,888e1bbd-ade7-4a31-8b69-76f1014afef9,36613679,26388,2325,2037,288,23,38
251,888e1bbd-ade7-4a31-8b69-76f1014afef9,36613679,26388,2804,2338,466,24,38
251,888e1bbd-ade7-4a31-8b69-76f1014afef9,36613679,26388,3053,2824,229,25,38
251,888e1bbd-ade7-4a31-8b69-76f1014afef9,36613679,26388,3062,3057,5,26,38
251,888e1bbd-ade7-4a31-8b69-76f1014afef9,36613679,26388,3293,3069,224,30,38
251,888e1bbd-ade7-4a31-8b69-76f1014afef9,36613679,26388,3484,3300,184,36,38
251,888e1bbd-ade7-4a31-8b69-76f1014afef9,36613679,26388,5001,3486,1515,37,38
251,888e1bbd-ade7-4a31-8b69-76f1014afef9,36613679,26388,5006,5003,3,38,38
259,f0e586c8-91a0-410e-b75c-63856d0d37c8,36692613,7824,42,5,37,0,18
259,f0e586c8-91a0-410e-b75c-63856d0d37c8,36692613,7824,128,43,85,6,18
259,f0e586c8-91a0-410e-b75c-63856d0d37c8,36692613,7824,762,132,630,8,18
259,f0e586c8-91a0-410e-b75c-63856d0d37c8,36692613,7824,769,123,-646,9,18
259,f0e586c8-91a0-410e-b75c-63856d0d37c8,36692613,7824,615,118,497,10,18
259,f0e586c8-91a0-410e-b75c-63856d0d37c8,36692613,7824,650,620,30,15,18
259,f0e586c8-91a0-410e-b75c-63856d0d37c8,36692613,7824,671,653,18,16,18
259,f0e586c8-91a0-410e-b75c-63856d0d37c8,36692613,7824,1546,672,874,17,18
259,f0e586c8-91a0-410e-b75c-63856d0d37c8,36692613,7824,1784,1570,214,18,18
250,1e2f2ec7-3bcd-4403-809d-5e419aac85a8,36682140,5154,81,6,75,0,50
250,1e2f2ec7-3bcd-4403-809d-5e419aac85a8,36682140,5154,270,99,171,1,50
250,1e2f2ec7-3bcd-4403-809d-5e419aac85a8,36682140,5154,248,150,-98,6,50
250,1e2f2ec7-3bcd-4403-809d-5e419aac85a8,36682140,5154,377,130,247,7,50
250,1e2f2ec7-3bcd-4403-809d-5e419aac85a8,36682140,5154,387,378,9,8,50
250,1e2f2ec7-3bcd-4403-809d-5e419aac85a8,36682140,5154,329,59,-270,9,50
250,1e2f2ec7-3bcd-4403-809d-5e419aac85a8,36682140,5154,111,50,61,10,50
250,1e2f2ec7-3bcd-4403-809d-5e419aac85a8,36682140,5154,129,113,16,11,50
250,1e2f2ec7-3bcd-4403-809d-5e419aac85a8,36682140,5154,261,135,126,26,50
250,1e2f2ec7-3bcd-4403-809d-5e419aac85a8,36682140,5154,316,269,47,27,50
250,1e2f2ec7-3bcd-4403-809d-5e419aac85a8,36682140,5154,1912,417,1495,28,50
250,1e2f2ec7-3bcd-4403-809d-5e419aac85a8,36682140,5154,1935,1420,-515,29,50
250,1e2f2ec7-3bcd-4403-809d-5e419aac85a8,36682140,5154,1787,1430,357,32,50
250,1e2f2ec7-3bcd-4403-809d-5e419aac85a8,36682140,5154,2089,1789,300,34,50
250,1e2f2ec7-3bcd-4403-809d-5e419aac85a8,36682140,5154,2415,2090,325,35,50
250,1e2f2ec7-3bcd-4403-809d-5e419aac85a8,36682140,5154,2505,2429,76,36,50
250,1e2f2ec7-3bcd-4403-809d-5e419aac85a8,36682140,5154,3276,2518,758,37,50
250,1e2f2ec7-3bcd-4403-809d-5e419aac85a8,36682140,5154,3489,3303,186,38,50
250,1e2f2ec7-3bcd-4403-809d-5e419aac85a8,36682140,5154,3462,3345,-117,39,50
250,1e2f2ec7-3bcd-4403-809d-5e419aac85a8,36682140,5154,3343,3337,-6,40,50
250,1e2f2ec7-3bcd-4403-809d-5e419aac85a8,36682140,5154,3489,3339,150,42,50
250,1e2f2ec7-3bcd-4403-809d-5e419aac85a8,36682140,5154,3481,3157,-324,48,50
250,1e2f2ec7-3bcd-4403-809d-5e419aac85a8,36682140,5154,3122,2237,-885,49,50
250,1e2f2ec7-3bcd-4403-809d-5e419aac85a8,36682140,5154,2191,1809,-382,50,50
250,1e2f2ec7-3bcd-4403-809d-5e419aac85a8,36607608,8544,588,16,572,0,65
250,1e2f2ec7-3bcd-4403-809d-5e419aac85a8,36607608,8544,911,592,319,4,65
250,1e2f2ec7-3bcd-4403-809d-5e419aac85a8,36607608,8544,1253,933,320,5,65
250,1e2f2ec7-3bcd-4403-809d-5e419aac85a8,36607608,8544,1886,1260,626,6,65
250,1e2f2ec7-3bcd-4403-809d-5e419aac85a8,36607608,8544,2118,1902,216,18,65
250,1e2f2ec7-3bcd-4403-809d-5e419aac85a8,36607608,8544,2495,2156,339,19,65
250,1e2f2ec7-3bcd-4403-809d-5e419aac85a8,36607608,8544,2742,2504,238,20,65
250,1e2f2ec7-3bcd-4403-809d-5e419aac85a8,36607608,8544,3055,2752,303,21,65
250,1e2f2ec7-3bcd-4403-809d-5e419aac85a8,36607608,8544,3105,3067,38,22,65
250,1e2f2ec7-3bcd-4403-809d-5e419aac85a8,36607608,8544,3764,3110,654,23,65
250,1e2f2ec7-3bcd-4403-809d-5e419aac85a8,36607608,8544,4429,3771,658,24,65
250,1e2f2ec7-3bcd-4403-809d-5e419aac85a8,36607608,8544,4487,4437,50,25,65
250,1e2f2ec7-3bcd-4403-809d-5e419aac85a8,36607608,8544,5345,4493,852,32,65
250,1e2f2ec7-3bcd-4403-809d-5e419aac85a8,36607608,8544,5924,5375,549,33,65
250,1e2f2ec7-3bcd-4403-809d-5e419aac85a8,36607608,8544,6879,6003,876,57,65
250,1e2f2ec7-3bcd-4403-809d-5e419aac85a8,36607608,8544,6873,6606,-267,58,65
250,1e2f2ec7-3bcd-4403-809d-5e419aac85a8,36607608,8544,6560,5584,-976,59,65
250,1e2f2ec7-3bcd-4403-809d-5e419aac85a8,36607608,8544,5579,4679,-900,61,65
250,1e2f2ec7-3bcd-4403-809d-5e419aac85a8,36607608,8544,4614,2634,-1980,62,65
250,1e2f2ec7-3bcd-4403-809d-5e419aac85a8,36607608,8544,2628,2609,-19,63,65
250,1e2f2ec7-3bcd-4403-809d-5e419aac85a8,36607608,8544,2509,1105,-1404,64,65
250,1e2f2ec7-3bcd-4403-809d-5e419aac85a8,36607608,8544,1003,0,-1003,65,65
259,e2f4c2a9-14b6-474b-ab60-db95aeb15582,36696568,6730,189,22,167,0,17
259,e2f4c2a9-14b6-474b-ab60-db95aeb15582,36696568,6730,130,129,-1,1,17
259,e2f4c2a9-14b6-474b-ab60-db95aeb15582,36696568,6730,87,0,-87,2,17
259,e2f4c2a9-14b6-474b-ab60-db95aeb15582,36696568,6730,178,3,175,3,17
259,e2f4c2a9-14b6-474b-ab60-db95aeb15582,36696568,6730,255,151,104,7,17
259,e2f4c2a9-14b6-474b-ab60-db95aeb15582,36696568,6730,595,260,335,8,17
259,e2f4c2a9-14b6-474b-ab60-db95aeb15582,36696568,6730,724,604,120,9,17
259,e2f4c2a9-14b6-474b-ab60-db95aeb15582,36696568,6730,1015,727,288,10,17
259,e2f4c2a9-14b6-474b-ab60-db95aeb15582,36696568,6730,1098,1020,78,11,17
259,e2f4c2a9-14b6-474b-ab60-db95aeb15582,36696568,6730,1489,1101,388,16,17
259,e2f4c2a9-14b6-474b-ab60-db95aeb15582,36696568,6730,1571,1504,67,17,17
259,e2f4c2a9-14b6-474b-ab60-db95aeb15582,36695497,1590,395,7,388,0,11
259,e2f4c2a9-14b6-474b-ab60-db95aeb15582,36695497,1590,468,407,61,1,11
259,e2f4c2a9-14b6-474b-ab60-db95aeb15582,36695497,1590,412,0,-412,2,11
259,e2f4c2a9-14b6-474b-ab60-db95aeb15582,36695497,1590,480,30,450,11,11
250,aa948803-9b2d-4563-a782-8061470e3403,36698055,2940,998,28,970,0,44
250,aa948803-9b2d-4563-a782-8061470e3403,36698055,2940,1275,1023,252,44,44
250,aa948803-9b2d-4563-a782-8061470e3403,36686682,6234,32,32,0,0,71
250,aa948803-9b2d-4563-a782-8061470e3403,36686682,6234,861,76,785,1,71
250,aa948803-9b2d-4563-a782-8061470e3403,36686682,6234,1703,904,799,25,71
250,aa948803-9b2d-4563-a782-8061470e3403,36686682,6234,1718,1706,12,26,71
250,aa948803-9b2d-4563-a782-8061470e3403,36686682,6234,2107,1729,378,53,71
250,aa948803-9b2d-4563-a782-8061470e3403,36686682,6234,2199,2116,83,54,71
250,aa948803-9b2d-4563-a782-8061470e3403,36686682,6234,3332,2200,1132,57,71
250,aa948803-9b2d-4563-a782-8061470e3403,36686682,6234,3335,3180,-155,58,71
250,aa948803-9b2d-4563-a782-8061470e3403,36686682,6234,3648,3210,438,65,71
250,aa948803-9b2d-4563-a782-8061470e3403,36686682,6234,4151,3665,486,66,71
250,aa948803-9b2d-4563-a782-8061470e3403,36686682,6234,4305,4152,153,67,71
250,aa948803-9b2d-4563-a782-8061470e3403,36686682,6234,4413,4327,86,68,71
250,aa948803-9b2d-4563-a782-8061470e3403,36686682,6234,4569,4415,154,70,71
250,aa948803-9b2d-4563-a782-8061470e3403,36686682,6234,4569,4568,1,71,71
250,3ea51445-accf-4442-bad1-617f81eae9e9,36682598,3774,414,9,405,0,11
250,3ea51445-accf-4442-bad1-617f81eae9e9,36682598,3774,360,0,-360,6,11
250,3ea51445-accf-4442-bad1-617f81eae9e9,36682598,3774,812,62,750,7,11
250,3ea51445-accf-4442-bad1-617f81eae9e9,36682598,3774,839,814,25,8,11
250,3ea51445-accf-4442-bad1-617f81eae9e9,36682598,3774,944,856,88,10,11
250,3ea51445-accf-4442-bad1-617f81eae9e9,36682598,3774,2109,1008,1101,11,11
259,2945e0de-ceb8-4757-ae84-833e5086b1d4,36697443,1748,511,6,505,0,12
259,2945e0de-ceb8-4757-ae84-833e5086b1d4,36697443,1748,566,515,51,8,12
259,2945e0de-ceb8-4757-ae84-833e5086b1d4,36697443,1748,638,563,75,10,12
259,2945e0de-ceb8-4757-ae84-833e5086b1d4,36697443,1748,638,638,0,12,12
259,2945e0de-ceb8-4757-ae84-833e5086b1d4,36697323,1482,107,8,99,0,11
259,2945e0de-ceb8-4757-ae84-833e5086b1d4,36697323,1482,151,108,43,1,11
259,2945e0de-ceb8-4757-ae84-833e5086b1d4,36697323,1482,372,160,212,10,11
259,2945e0de-ceb8-4757-ae84-833e5086b1d4,36697323,1482,372,371,1,11,11
259,b97a80b7-2580-4470-80e3-2689ebda786f,36697713,1678,7,2,5,0,5
259,b97a80b7-2580-4470-80e3-2689ebda786f,36697713,1678,195,14,181,1,5
259,b97a80b7-2580-4470-80e3-2689ebda786f,36697713,1678,282,196,86,4,5
259,b97a80b7-2580-4470-80e3-2689ebda786f,36697713,1678,338,286,52,5,5
259,b97a80b7-2580-4470-80e3-2689ebda786f,36699036,1526,228,3,225,0,3
259,b97a80b7-2580-4470-80e3-2689ebda786f,36699036,1526,338,232,106,1,3
259,b97a80b7-2580-4470-80e3-2689ebda786f,36699036,1526,362,339,23,2,3
259,b97a80b7-2580-4470-80e3-2689ebda786f,36699036,1526,416,377,39,3,3
250,1e348ae3-069a-4bf0-a2d1-b9d56504acd2,36700080,4578,292,3,289,0,18
250,1e348ae3-069a-4bf0-a2d1-b9d56504acd2,36700080,4578,370,192,178,3,18
250,1e348ae3-069a-4bf0-a2d1-b9d56504acd2,36700080,4578,896,383,513,4,18
250,1e348ae3-069a-4bf0-a2d1-b9d56504acd2,36700080,4578,1208,929,279,5,18
250,1e348ae3-069a-4bf0-a2d1-b9d56504acd2,36700080,4578,1453,1222,231,14,18
250,1e348ae3-069a-4bf0-a2d1-b9d56504acd2,36700080,4578,1771,1456,315,16,18
250,1e348ae3-069a-4bf0-a2d1-b9d56504acd2,36700080,4578,2382,1791,591,17,18
250,1e348ae3-069a-4bf0-a2d1-b9d56504acd2,36700080,4578,2913,2383,530,18,18
125,6b82f256-a283-46f9-be1c-f69e3c4895d9,36676576,2355,237,9,228,0,4
125,6b82f256-a283-46f9-be1c-f69e3c4895d9,36676576,2355,690,258,432,1,4
125,6b82f256-a283-46f9-be1c-f69e3c4895d9,36676576,2355,690,358,332,4,4
125,6b82f256-a283-46f9-be1c-f69e3c4895d9,36699642,8421,1047,44,1003,0,2
125,6b82f256-a283-46f9-be1c-f69e3c4895d9,36699642,8421,2643,1062,1581,1,2
125,6b82f256-a283-46f9-be1c-f69e3c4895d9,36699642,8421,2646,2644,2,2,2
258,06a293bb-c63d-44ca-89bb-b253c3e69b1d,36702468,3606,142,3,139,0,3
258,06a293bb-c63d-44ca-89bb-b253c3e69b1d,36702468,3606,333,155,178,1,3
258,06a293bb-c63d-44ca-89bb-b253c3e69b1d,36702468,3606,300,0,-300,3,3
250,8ce51d10-7fa5-452f-88eb-02618369e008,36702468,3606,304,1,303,0,300
250,8ce51d10-7fa5-452f-88eb-02618369e008,36702468,3606,694,314,380,1,300
250,8ce51d10-7fa5-452f-88eb-02618369e008,36702468,3606,1139,701,438,5,300
250,8ce51d10-7fa5-452f-88eb-02618369e008,36702468,3606,1324,1142,182,6,300
250,8ce51d10-7fa5-452f-88eb-02618369e008,36702468,3606,1941,1341,600,7,300
250,8ce51d10-7fa5-452f-88eb-02618369e008,36702468,3606,1892,1467,-425,57,300
250,8ce51d10-7fa5-452f-88eb-02618369e008,36702468,3606,1453,269,-1184,58,300
250,8ce51d10-7fa5-452f-88eb-02618369e008,36702468,3606,266,0,-266,59,300
250,8ce51d10-7fa5-452f-88eb-02618369e008,36702468,3606,510,29,481,162,300
250,8ce51d10-7fa5-452f-88eb-02618369e008,36702468,3606,1014,527,487,164,300
250,8ce51d10-7fa5-452f-88eb-02618369e008,36702468,3606,977,695,-282,166,300
250,8ce51d10-7fa5-452f-88eb-02618369e008,36702468,3606,671,256,-415,170,300
250,8ce51d10-7fa5-452f-88eb-02618369e008,36702468,3606,1255,310,945,178,300
250,8ce51d10-7fa5-452f-88eb-02618369e008,36702468,3606,1941,1381,560,179,300
250,8ce51d10-7fa5-452f-88eb-02618369e008,36702468,3531,1866,1866,0,289,300
250,8ce51d10-7fa5-452f-88eb-02618369e008,36702468,3606,1941,1910,31,300,300
250,8ce51d10-7fa5-452f-88eb-02618369e008,36702336,2979,217,3,214,0,22
250,8ce51d10-7fa5-452f-88eb-02618369e008,36702336,2979,221,221,0,1,22
250,8ce51d10-7fa5-452f-88eb-02618369e008,36702336,2979,654,239,415,2,22
250,8ce51d10-7fa5-452f-88eb-02618369e008,36702336,2979,1054,655,399,3,22
250,8ce51d10-7fa5-452f-88eb-02618369e008,36702336,2979,1012,639,-373,17,22
250,8ce51d10-7fa5-452f-88eb-02618369e008,36702336,2979,631,0,-631,18,22
250,8ce51d10-7fa5-452f-88eb-02618369e008,36702336,2979,518,5,513,19,22
250,8ce51d10-7fa5-452f-88eb-02618369e008,36702336,2979,532,522,10,20,22
250,8ce51d10-7fa5-452f-88eb-02618369e008,36702336,2979,1314,541,773,22,22
250,8ce51d10-7fa5-452f-88eb-02618369e008,36701273,3831,653,55,598,0,14
250,8ce51d10-7fa5-452f-88eb-02618369e008,36701273,3831,928,668,260,6,14
250,8ce51d10-7fa5-452f-88eb-02618369e008,36701273,3831,1012,940,72,7,14
250,8ce51d10-7fa5-452f-88eb-02618369e008,36701273,3831,1764,1057,707,11,14
250,8ce51d10-7fa5-452f-88eb-02618369e008,36701273,3831,2166,1815,351,12,14
250,8ce51d10-7fa5-452f-88eb-02618369e008,36701273,3831,1955,0,-1955,14,14
125,ec229e43-38c8-42bd-9209-15578f93daf9,36672285,7914,708,6,702,0,29
125,ec229e43-38c8-42bd-9209-15578f93daf9,36672285,7914,1158,723,435,1,29
125,ec229e43-38c8-42bd-9209-15578f93daf9,36672285,7914,1609,1183,426,12,29
125,ec229e43-38c8-42bd-9209-15578f93daf9,36672285,7914,1821,1621,200,13,29
125,ec229e43-38c8-42bd-9209-15578f93daf9,36672285,7914,2111,1828,283,21,29
125,ec229e43-38c8-42bd-9209-15578f93daf9,36672285,7914,2140,2113,27,22,29
125,ec229e43-38c8-42bd-9209-15578f93daf9,36672285,7914,3426,2166,1260,28,29
125,ec229e43-38c8-42bd-9209-15578f93daf9,36672285,7914,5744,3427,2317,29,29
259,a6201a15-8f8a-445d-a34a-b85dfb32306a,36706761,1300,116,5,111,0,4
259,a6201a15-8f8a-445d-a34a-b85dfb32306a,36706761,1300,168,117,51,1,4
259,a6201a15-8f8a-445d-a34a-b85dfb32306a,36706761,1300,189,170,19,2,4
259,a6201a15-8f8a-445d-a34a-b85dfb32306a,36706761,1300,190,190,0,3,4
259,a6201a15-8f8a-445d-a34a-b85dfb32306a,36706761,1300,189,188,-1,4,4
259,a6201a15-8f8a-445d-a34a-b85dfb32306a,36702589,3850,131,10,121,0,29
259,a6201a15-8f8a-445d-a34a-b85dfb32306a,36702589,3850,264,132,132,1,29
259,a6201a15-8f8a-445d-a34a-b85dfb32306a,36702589,3850,561,272,289,2,29
259,a6201a15-8f8a-445d-a34a-b85dfb32306a,36702589,3850,589,562,27,3,29
259,a6201a15-8f8a-445d-a34a-b85dfb32306a,36702589,3850,705,590,115,16,29
259,a6201a15-8f8a-445d-a34a-b85dfb32306a,36702589,3850,755,710,45,17,29
259,a6201a15-8f8a-445d-a34a-b85dfb32306a,36702589,3850,819,760,59,24,29
259,a6201a15-8f8a-445d-a34a-b85dfb32306a,36702589,3850,1361,820,541,25,29
259,a6201a15-8f8a-445d-a34a-b85dfb32306a,36702589,3850,1529,1379,150,26,29
259,a6201a15-8f8a-445d-a34a-b85dfb32306a,36702589,3850,2720,1528,1192,27,29
259,a6201a15-8f8a-445d-a34a-b85dfb32306a,36702589,3850,2740,2725,15,29,29
251,c557ee3d-a597-498e-a6c7-107aa7bdba47,36702468,7164,160,8,152,0,38
251,c557ee3d-a597-498e-a6c7-107aa7bdba47,36702468,7164,239,161,78,1,38
251,c557ee3d-a597-498e-a6c7-107aa7bdba47,36702468,7164,295,241,54,2,38
251,c557ee3d-a597-498e-a6c7-107aa7bdba47,36702468,7164,493,299,194,5,38
251,c557ee3d-a597-498e-a6c7-107aa7bdba47,36702468,7164,495,494,1,6,38
251,c557ee3d-a597-498e-a6c7-107aa7bdba47,36702468,7164,565,496,69,10,38
251,c557ee3d-a597-498e-a6c7-107aa7bdba47,36702468,7164,628,567,61,11,38
251,c557ee3d-a597-498e-a6c7-107aa7bdba47,36702468,7164,803,631,172,18,38
251,c557ee3d-a597-498e-a6c7-107aa7bdba47,36702468,7164,853,807,46,19,38
251,c557ee3d-a597-498e-a6c7-107aa7bdba47,36702468,7164,982,860,122,23,38
251,c557ee3d-a597-498e-a6c7-107aa7bdba47,36702468,7164,1168,986,182,24,38
251,c557ee3d-a597-498e-a6c7-107aa7bdba47,36702468,7164,1175,943,-232,25,38
251,c557ee3d-a597-498e-a6c7-107aa7bdba47,36702468,7164,1030,952,78,26,38
251,c557ee3d-a597-498e-a6c7-107aa7bdba47,36702468,7164,1289,1034,255,27,38
251,c557ee3d-a597-498e-a6c7-107aa7bdba47,36702468,7164,1456,1298,158,29,38
251,c557ee3d-a597-498e-a6c7-107aa7bdba47,36702468,7164,1572,1457,115,32,38
251,c557ee3d-a597-498e-a6c7-107aa7bdba47,36702468,7164,1621,1576,45,33,38
251,c557ee3d-a597-498e-a6c7-107aa7bdba47,36702468,7164,1848,1631,217,38,38
24,fcaeb519-5ef0-49f3-973a-1f965c899b58,36702468,3630,39,2,37,0,61
24,fcaeb519-5ef0-49f3-973a-1f965c899b58,36702468,3630,88,41,47,1,61
24,fcaeb519-5ef0-49f3-973a-1f965c899b58,36702468,3630,149,89,60,2,61
24,fcaeb519-5ef0-49f3-973a-1f965c899b58,36702468,3630,202,151,51,3,61
24,fcaeb519-5ef0-49f3-973a-1f965c899b58,36702468,3630,251,204,47,4,61
24,fcaeb519-5ef0-49f3-973a-1f965c899b58,36702468,3630,255,253,2,5,61
24,fcaeb519-5ef0-49f3-973a-1f965c899b58,36702468,3630,307,256,51,19,61
24,fcaeb519-5ef0-49f3-973a-1f965c899b58,36702468,3630,498,315,183,20,61
24,fcaeb519-5ef0-49f3-973a-1f965c899b58,36702468,3630,608,506,102,21,61
24,fcaeb519-5ef0-49f3-973a-1f965c899b58,36702468,3630,732,611,121,40,61
24,fcaeb519-5ef0-49f3-973a-1f965c899b58,36702468,3630,826,738,88,41,61
24,fcaeb519-5ef0-49f3-973a-1f965c899b58,36702468,3630,923,829,94,42,61
24,fcaeb519-5ef0-49f3-973a-1f965c899b58,36702468,3630,945,909,-36,43,61
24,fcaeb519-5ef0-49f3-973a-1f965c899b58,36702468,3630,905,886,-19,44,61
24,fcaeb519-5ef0-49f3-973a-1f965c899b58,36702468,3630,938,887,51,46,61
24,fcaeb519-5ef0-49f3-973a-1f965c899b58,36702468,3630,981,940,41,47,61
24,fcaeb519-5ef0-49f3-973a-1f965c899b58,36702468,3630,1043,983,60,48,61
24,fcaeb519-5ef0-49f3-973a-1f965c899b58,36702468,3630,1049,1045,4,49,61
24,fcaeb519-5ef0-49f3-973a-1f965c899b58,36702468,3630,1610,1050,560,60,61
24,fcaeb519-5ef0-49f3-973a-1f965c899b58,36702468,3630,2616,1621,995,61,61
24,fcaeb519-5ef0-49f3-973a-1f965c899b58,36707573,4660,47,1,46,0,2
24,fcaeb519-5ef0-49f3-973a-1f965c899b58,36707573,4660,158,50,108,1,2
24,fcaeb519-5ef0-49f3-973a-1f965c899b58,36707573,4660,233,161,72,2,2
250,f113cdbc-c03b-4cc4-bc3d-de4c005301ec,36706761,5526,407,1,406,0,29
250,f113cdbc-c03b-4cc4-bc3d-de4c005301ec,36706761,5526,434,409,25,5,29
250,f113cdbc-c03b-4cc4-bc3d-de4c005301ec,36706761,5526,815,440,375,6,29
250,f113cdbc-c03b-4cc4-bc3d-de4c005301ec,36706761,5526,1276,832,444,13,29
250,f113cdbc-c03b-4cc4-bc3d-de4c005301ec,36706761,5526,1584,1279,305,19,29
250,f113cdbc-c03b-4cc4-bc3d-de4c005301ec,36706761,5526,1820,1608,212,20,29
250,f113cdbc-c03b-4cc4-bc3d-de4c005301ec,36706761,5526,2217,1825,392,22,29
250,f113cdbc-c03b-4cc4-bc3d-de4c005301ec,36706761,5526,2926,2234,692,23,29
250,f113cdbc-c03b-4cc4-bc3d-de4c005301ec,36706761,5526,3549,2928,621,24,29
250,f113cdbc-c03b-4cc4-bc3d-de4c005301ec,36706761,5526,3861,3551,310,25,29
250,f113cdbc-c03b-4cc4-bc3d-de4c005301ec,36706761,5526,3852,3422,-430,29,29
250,f113cdbc-c03b-4cc4-bc3d-de4c005301ec,36710667,2721,565,24,541,0,6
250,f113cdbc-c03b-4cc4-bc3d-de4c005301ec,36710667,2721,786,568,218,1,6
250,f113cdbc-c03b-4cc4-bc3d-de4c005301ec,36710667,2721,919,798,121,2,6
250,f113cdbc-c03b-4cc4-bc3d-de4c005301ec,36710667,2721,1056,937,119,6,6
126,36c808dc-abe0-4e2d-a0b1-bd6e28b3379c,36710828,1774,522,7,515,0,28
126,36c808dc-abe0-4e2d-a0b1-bd6e28b3379c,36710828,1774,533,525,8,1,28
126,36c808dc-abe0-4e2d-a0b1-bd6e28b3379c,36710828,1774,579,535,44,14,28
126,36c808dc-abe0-4e2d-a0b1-bd6e28b3379c,36710828,1774,664,589,75,15,28
126,36c808dc-abe0-4e2d-a0b1-bd6e28b3379c,36710828,1774,664,662,2,25,28
126,36c808dc-abe0-4e2d-a0b1-bd6e28b3379c,36710828,1774,663,645,-18,26,28
126,36c808dc-abe0-4e2d-a0b1-bd6e28b3379c,36710828,1774,646,92,-554,27,28
126,36c808dc-abe0-4e2d-a0b1-bd6e28b3379c,36710828,1774,88,75,-13,28,28
250,77c0d629-ce2a-4103-8157-fccc93d62d62,36712040,6180,525,12,513,0,28
250,77c0d629-ce2a-4103-8157-fccc93d62d62,36712040,6180,829,540,289,3,28
250,77c0d629-ce2a-4103-8157-fccc93d62d62,36712040,6180,1071,848,223,4,28
250,77c0d629-ce2a-4103-8157-fccc93d62d62,36712040,6180,1195,1072,123,8,28
250,77c0d629-ce2a-4103-8157-fccc93d62d62,36712040,6180,1603,1225,378,9,28
250,77c0d629-ce2a-4103-8157-fccc93d62d62,36712040,6180,2085,1605,480,15,28
250,77c0d629-ce2a-4103-8157-fccc93d62d62,36712040,6180,2253,2087,166,16,28
250,77c0d629-ce2a-4103-8157-fccc93d62d62,36712040,6180,2707,2296,411,17,28
250,77c0d629-ce2a-4103-8157-fccc93d62d62,36712040,6180,2982,2714,268,19,28
250,77c0d629-ce2a-4103-8157-fccc93d62d62,36712040,6180,3139,2984,155,21,28
250,77c0d629-ce2a-4103-8157-fccc93d62d62,36712040,6180,3250,3154,96,22,28
250,77c0d629-ce2a-4103-8157-fccc93d62d62,36712040,6180,3692,3254,438,24,28
250,77c0d629-ce2a-4103-8157-fccc93d62d62,36712040,6180,4515,3729,786,25,28
250,77c0d629-ce2a-4103-8157-fccc93d62d62,36712040,6180,4475,4052,-423,28,28
250,77c0d629-ce2a-4103-8157-fccc93d62d62,36707255,10626,463,10,453,0,29
250,77c0d629-ce2a-4103-8157-fccc93d62d62,36707255,10626,911,476,435,2,29
250,77c0d629-ce2a-4103-8157-fccc93d62d62,36707255,10626,1234,915,319,4,29
250,77c0d629-ce2a-4103-8157-fccc93d62d62,36707255,10626,1325,1320,5,5,29
250,77c0d629-ce2a-4103-8157-fccc93d62d62,36707255,10626,1390,1362,28,8,29
250,77c0d629-ce2a-4103-8157-fccc93d62d62,36707255,10626,1669,1419,250,9,29
250,77c0d629-ce2a-4103-8157-fccc93d62d62,36707255,10626,2114,1679,435,16,29
250,77c0d629-ce2a-4103-8157-fccc93d62d62,36707255,10626,2202,2120,82,18,29
250,77c0d629-ce2a-4103-8157-fccc93d62d62,36707255,10626,2451,2218,233,19,29
250,77c0d629-ce2a-4103-8157-fccc93d62d62,36707255,10626,2868,2466,402,22,29
250,77c0d629-ce2a-4103-8157-fccc93d62d62,36707255,10626,3285,2875,410,24,29
250,77c0d629-ce2a-4103-8157-fccc93d62d62,36707255,10626,3501,3298,203,26,29
250,77c0d629-ce2a-4103-8157-fccc93d62d62,36707255,10626,3978,3531,447,27,29
250,77c0d629-ce2a-4103-8157-fccc93d62d62,36707255,10626,6058,4014,2044,28,29
250,77c0d629-ce2a-4103-8157-fccc93d62d62,36707255,10626,7671,6142,1529,29,29
250,77c0d629-ce2a-4103-8157-fccc93d62d62,36651699,6186,603,44,559,0,136
250,77c0d629-ce2a-4103-8157-fccc93d62d62,36651699,6186,940,607,333,4,136
250,77c0d629-ce2a-4103-8157-fccc93d62d62,36651699,6186,1055,962,93,5,136
250,77c0d629-ce2a-4103-8157-fccc93d62d62,36651699,6186,1497,1063,434,6,136
250,77c0d629-ce2a-4103-8157-fccc93d62d62,36651699,6186,1451,953,-498,88,136
250,77c0d629-ce2a-4103-8157-fccc93d62d62,36651699,6186,939,894,-45,89,136
250,77c0d629-ce2a-4103-8157-fccc93d62d62,36651699,6186,889,0,-889,97,136
250,77c0d629-ce2a-4103-8157-fccc93d62d62,36651699,6186,493,4,489,98,136
250,77c0d629-ce2a-4103-8157-fccc93d62d62,36651699,6186,1203,512,691,99,136
250,77c0d629-ce2a-4103-8157-fccc93d62d62,36651699,6186,1549,1206,343,100,136
250,77c0d629-ce2a-4103-8157-fccc93d62d62,36651699,6186,2018,1563,455,106,136
250,77c0d629-ce2a-4103-8157-fccc93d62d62,36651699,6186,2101,2020,81,107,136
250,77c0d629-ce2a-4103-8157-fccc93d62d62,36651699,6186,2593,2106,487,119,136
250,77c0d629-ce2a-4103-8157-fccc93d62d62,36651699,6186,2605,2596,9,120,136
250,77c0d629-ce2a-4103-8157-fccc93d62d62,36651699,6186,2625,2612,13,121,136
250,77c0d629-ce2a-4103-8157-fccc93d62d62,36651699,6186,2888,2645,243,122,136
250,77c0d629-ce2a-4103-8157-fccc93d62d62,36651699,6186,3244,2904,340,124,136
250,77c0d629-ce2a-4103-8157-fccc93d62d62,36651699,6186,3635,3252,383,126,136
250,77c0d629-ce2a-4103-8157-fccc93d62d62,36651699,6186,3978,3648,330,131,136
250,77c0d629-ce2a-4103-8157-fccc93d62d62,36651699,6186,4232,3986,246,133,136
250,77c0d629-ce2a-4103-8157-fccc93d62d62,36651699,6186,4238,4233,5,134,136
250,77c0d629-ce2a-4103-8157-fccc93d62d62,36651699,6186,4521,4244,277,135,136
250,77c0d629-ce2a-4103-8157-fccc93d62d62,36651699,6186,4521,4520,1,136,136
125,f00a9c32-e92e-4f26-9b81-8ef4d699482b,36713699,2953,8,8,0,0,12
125,f00a9c32-e92e-4f26-9b81-8ef4d699482b,36713699,2953,93,16,77,1,12
125,f00a9c32-e92e-4f26-9b81-8ef4d699482b,36713699,2953,174,95,79,12,12
258,e88a195c-fb76-49a6-9fe9-8f67c2f3d76e,36717050,2268,600,27,573,0,2
258,e88a195c-fb76-49a6-9fe9-8f67c2f3d76e,36717050,2268,575,0,-575,2,2
250,cbb60f43-967b-4338-a3df-4b8834f02906,36711711,1869,112,4,108,0,4
250,cbb60f43-967b-4338-a3df-4b8834f02906,36711711,1869,204,116,88,1,4
250,cbb60f43-967b-4338-a3df-4b8834f02906,36711711,1869,204,203,1,2,4
250,cbb60f43-967b-4338-a3df-4b8834f02906,36711711,1869,188,145,-43,3,4
250,cbb60f43-967b-4338-a3df-4b8834f02906,36711711,1869,204,0,204,4,4
250,cbb60f43-967b-4338-a3df-4b8834f02906,36712690,4368,459,61,398,0,24
250,cbb60f43-967b-4338-a3df-4b8834f02906,36712690,4368,500,473,27,1,24
250,cbb60f43-967b-4338-a3df-4b8834f02906,36712690,4368,858,503,355,4,24
250,cbb60f43-967b-4338-a3df-4b8834f02906,36712690,4368,984,984,0,5,24
250,cbb60f43-967b-4338-a3df-4b8834f02906,36712690,4368,772,512,-260,10,24
250,cbb60f43-967b-4338-a3df-4b8834f02906,36712690,4368,509,493,-16,11,24
250,cbb60f43-967b-4338-a3df-4b8834f02906,36712690,4368,1143,494,649,12,24
250,cbb60f43-967b-4338-a3df-4b8834f02906,36712690,4368,1598,1152,446,15,24
250,cbb60f43-967b-4338-a3df-4b8834f02906,36712690,4368,1673,1603,70,16,24
250,cbb60f43-967b-4338-a3df-4b8834f02906,36712690,4368,1936,1693,243,19,24
250,cbb60f43-967b-4338-a3df-4b8834f02906,36712690,4368,1853,0,-1853,20,24
250,cbb60f43-967b-4338-a3df-4b8834f02906,36712690,4368,279,2,277,21,24
250,cbb60f43-967b-4338-a3df-4b8834f02906,36712690,4368,2377,317,2060,22,24
250,cbb60f43-967b-4338-a3df-4b8834f02906,36712690,4368,2703,2378,325,24,24
250,cbb60f43-967b-4338-a3df-4b8834f02906,36711903,6639,435,43,392,0,39
250,cbb60f43-967b-4338-a3df-4b8834f02906,36711903,6639,457,441,16,1,39
250,cbb60f43-967b-4338-a3df-4b8834f02906,36711903,6639,774,474,300,5,39
250,cbb60f43-967b-4338-a3df-4b8834f02906,36711903,6639,1262,785,477,6,39
250,cbb60f43-967b-4338-a3df-4b8834f02906,36711903,6639,1446,1269,177,7,39
250,cbb60f43-967b-4338-a3df-4b8834f02906,36711903,6639,1576,1474,102,8,39
250,cbb60f43-967b-4338-a3df-4b8834f02906,36711903,6639,1950,1600,350,10,39
250,cbb60f43-967b-4338-a3df-4b8834f02906,36711903,6639,1989,1956,33,11,39
250,cbb60f43-967b-4338-a3df-4b8834f02906,36711903,6639,2485,2013,472,15,39
250,cbb60f43-967b-4338-a3df-4b8834f02906,36711903,6639,2523,2493,30,16,39
250,cbb60f43-967b-4338-a3df-4b8834f02906,36711903,6639,3056,2556,500,17,39
250,cbb60f43-967b-4338-a3df-4b8834f02906,36711903,6639,3525,3065,460,18,39
250,cbb60f43-967b-4338-a3df-4b8834f02906,36711903,6639,3541,3541,0,21,39
250,cbb60f43-967b-4338-a3df-4b8834f02906,36711903,6639,4109,3586,523,22,39
250,cbb60f43-967b-4338-a3df-4b8834f02906,36711903,6639,4535,4127,408,23,39
250,cbb60f43-967b-4338-a3df-4b8834f02906,36711903,6639,4666,4146,-520,24,39
250,cbb60f43-967b-4338-a3df-4b8834f02906,36711903,6639,4112,3866,-246,25,39
250,cbb60f43-967b-4338-a3df-4b8834f02906,36711903,6639,4399,3889,510,26,39
250,cbb60f43-967b-4338-a3df-4b8834f02906,36711903,6639,4892,4402,490,27,39
250,cbb60f43-967b-4338-a3df-4b8834f02906,36711903,6639,4894,4894,0,28,39
250,cbb60f43-967b-4338-a3df-4b8834f02906,36711903,6639,4875,4749,-126,30,39
250,cbb60f43-967b-4338-a3df-4b8834f02906,36711903,6639,4686,4353,-333,31,39
250,cbb60f43-967b-4338-a3df-4b8834f02906,36711903,6639,4974,4356,618,38,39
250,cbb60f43-967b-4338-a3df-4b8834f02906,36711903,6639,4974,4973,1,39,39
250,cbb60f43-967b-4338-a3df-4b8834f02906,36711903,6639,4974,4973,-1,39,39
250,cbb60f43-967b-4338-a3df-4b8834f02906,36711908,5787,440,47,393,0,58
250,cbb60f43-967b-4338-a3df-4b8834f02906,36711908,5787,473,445,28,1,58
250,cbb60f43-967b-4338-a3df-4b8834f02906,36711908,5787,1128,492,636,10,58
250,cbb60f43-967b-4338-a3df-4b8834f02906,36711908,5787,1669,1132,537,11,58
250,cbb60f43-967b-4338-a3df-4b8834f02906,36711908,5787,2328,1714,614,27,58
250,cbb60f43-967b-4338-a3df-4b8834f02906,36711908,5787,2857,2329,528,34,58
250,cbb60f43-967b-4338-a3df-4b8834f02906,36711908,5787,3391,2886,505,48,58
250,cbb60f43-967b-4338-a3df-4b8834f02906,36711908,5787,3402,3395,7,49,58
250,cbb60f43-967b-4338-a3df-4b8834f02906,36711908,5787,3420,3404,16,52,58
250,cbb60f43-967b-4338-a3df-4b8834f02906,36711908,5787,3750,3438,312,53,58
250,cbb60f43-967b-4338-a3df-4b8834f02906,36711908,5787,3946,3776,170,55,58
250,cbb60f43-967b-4338-a3df-4b8834f02906,36711908,5787,4037,3966,71,56,58
250,cbb60f43-967b-4338-a3df-4b8834f02906,36711908,5787,4122,4046,76,57,58
250,cbb60f43-967b-4338-a3df-4b8834f02906,36711908,5787,4122,4121,1,58,58
250,8aed27e2-aa97-4d19-a34c-9b43fac21109,36703721,11442,783,22,761,0,58
250,8aed27e2-aa97-4d19-a34c-9b43fac21109,36703721,11442,1521,841,680,7,58
250,8aed27e2-aa97-4d19-a34c-9b43fac21109,36703721,11442,1523,1522,1,8,58
250,8aed27e2-aa97-4d19-a34c-9b43fac21109,36703721,11442,1718,1525,193,9,58
250,8aed27e2-aa97-4d19-a34c-9b43fac21109,36703721,11442,1729,1719,10,10,58
250,8aed27e2-aa97-4d19-a34c-9b43fac21109,36703721,11442,2507,1731,776,28,58
250,8aed27e2-aa97-4d19-a34c-9b43fac21109,36703721,11442,2636,2510,126,29,58
250,8aed27e2-aa97-4d19-a34c-9b43fac21109,36703721,11442,2876,2662,214,30,58
250,8aed27e2-aa97-4d19-a34c-9b43fac21109,36703721,11442,3125,2877,248,37,58
250,8aed27e2-aa97-4d19-a34c-9b43fac21109,36703721,11442,3206,2916,-290,38,58
250,8aed27e2-aa97-4d19-a34c-9b43fac21109,36703721,11442,2921,2915,6,39,58
250,8aed27e2-aa97-4d19-a34c-9b43fac21109,36703721,11442,3249,2922,327,40,58
250,8aed27e2-aa97-4d19-a34c-9b43fac21109,36703721,11442,3503,3260,243,41,58
250,8aed27e2-aa97-4d19-a34c-9b43fac21109,36703721,11442,3620,3505,115,42,58
250,8aed27e2-aa97-4d19-a34c-9b43fac21109,36703721,11442,3636,3636,0,43,58
250,8aed27e2-aa97-4d19-a34c-9b43fac21109,36703721,11442,4234,3656,578,44,58
250,8aed27e2-aa97-4d19-a34c-9b43fac21109,36703721,11442,5881,4293,1588,55,58
250,8aed27e2-aa97-4d19-a34c-9b43fac21109,36703721,11442,6062,5901,161,56,58
250,8aed27e2-aa97-4d19-a34c-9b43fac21109,36703721,11442,7207,6069,1138,57,58
250,8aed27e2-aa97-4d19-a34c-9b43fac21109,36703721,11442,8387,7285,1102,58,58
250,8aed27e2-aa97-4d19-a34c-9b43fac21109,36716248,6996,465,7,458,0,66
250,8aed27e2-aa97-4d19-a34c-9b43fac21109,36716248,6996,466,466,0,1,66
250,8aed27e2-aa97-4d19-a34c-9b43fac21109,36716248,6996,524,155,-369,4,66
250,8aed27e2-aa97-4d19-a34c-9b43fac21109,36716248,6996,474,0,474,5,66
250,8aed27e2-aa97-4d19-a34c-9b43fac21109,36716248,6996,699,497,202,6,66
250,8aed27e2-aa97-4d19-a34c-9b43fac21109,36716248,6996,689,553,-136,9,66
250,8aed27e2-aa97-4d19-a34c-9b43fac21109,36716248,6996,550,515,-35,10,66
250,8aed27e2-aa97-4d19-a34c-9b43fac21109,36716248,6996,494,344,-150,11,66
250,8aed27e2-aa97-4d19-a34c-9b43fac21109,36716248,6996,1151,348,803,13,66
250,8aed27e2-aa97-4d19-a34c-9b43fac21109,36716248,6996,1398,1155,243,15,66
250,8aed27e2-aa97-4d19-a34c-9b43fac21109,36716248,6996,1492,1415,77,16,66
250,8aed27e2-aa97-4d19-a34c-9b43fac21109,36716248,6996,1566,1500,66,19,66
250,8aed27e2-aa97-4d19-a34c-9b43fac21109,36716248,6996,1743,1596,147,20,66
250,8aed27e2-aa97-4d19-a34c-9b43fac21109,36716248,6996,1930,1749,181,32,66
250,8aed27e2-aa97-4d19-a34c-9b43fac21109,36716248,6996,1965,1932,33,33,66
250,8aed27e2-aa97-4d19-a34c-9b43fac21109,36716248,6996,2284,2002,282,37,66
250,8aed27e2-aa97-4d19-a34c-9b43fac21109,36716248,6996,2326,2288,38,38,66
250,8aed27e2-aa97-4d19-a34c-9b43fac21109,36716248,6996,2600,2407,193,48,66
250,8aed27e2-aa97-4d19-a34c-9b43fac21109,36716248,6996,2618,2605,13,49,66
250,8aed27e2-aa97-4d19-a34c-9b43fac21109,36716248,6996,2918,2628,290,54,66
250,8aed27e2-aa97-4d19-a34c-9b43fac21109,36716248,6996,2951,2926,25,55,66
250,8aed27e2-aa97-4d19-a34c-9b43fac21109,36716248,6996,3288,2978,310,57,66
250,8aed27e2-aa97-4d19-a34c-9b43fac21109,36716248,6996,3447,3299,148,58,66
250,8aed27e2-aa97-4d19-a34c-9b43fac21109,36716248,6996,3622,3473,149,59,66
250,8aed27e2-aa97-4d19-a34c-9b43fac21109,36716248,6996,3778,3632,146,61,66
250,8aed27e2-aa97-4d19-a34c-9b43fac21109,36716248,6996,4536,3852,684,62,66
250,8aed27e2-aa97-4d19-a34c-9b43fac21109,36716248,6996,5135,4550,585,64,66
250,8aed27e2-aa97-4d19-a34c-9b43fac21109,36716248,6996,5331,5166,165,66,66
8,423bf1ac-1e57-4c57-acf9-d73c47b2559e,36708583,12029,1963,8,1955,0,34
8,423bf1ac-1e57-4c57-acf9-d73c47b2559e,36708583,12029,2940,1982,958,1,34
8,423bf1ac-1e57-4c57-acf9-d73c47b2559e,36708583,12029,4559,2964,1595,2,34
8,423bf1ac-1e57-4c57-acf9-d73c47b2559e,36708583,12029,5886,4605,1281,3,34
8,423bf1ac-1e57-4c57-acf9-d73c47b2559e,36708583,12029,5881,5876,-5,6,34
8,423bf1ac-1e57-4c57-acf9-d73c47b2559e,36708583,12029,5882,5877,5,7,34
8,423bf1ac-1e57-4c57-acf9-d73c47b2559e,36708583,12029,5973,5898,75,32,34
8,423bf1ac-1e57-4c57-acf9-d73c47b2559e,36708583,12029,6697,5975,722,33,34
8,423bf1ac-1e57-4c57-acf9-d73c47b2559e,36708583,12029,6737,6704,33,34,34
250,405d0dc8-3494-4b2b-a840-e2720211084a,36721892,3900,449,25,424,0,29
250,405d0dc8-3494-4b2b-a840-e2720211084a,36721892,3900,762,450,312,4,29
250,405d0dc8-3494-4b2b-a840-e2720211084a,36721892,3900,976,774,202,8,29
250,405d0dc8-3494-4b2b-a840-e2720211084a,36721892,3900,1616,984,632,12,29
250,405d0dc8-3494-4b2b-a840-e2720211084a,36721892,3900,2235,1653,582,16,29
250,405d0dc8-3494-4b2b-a840-e2720211084a,36721892,3900,2216,654,-1562,26,29
250,405d0dc8-3494-4b2b-a840-e2720211084a,36721892,3900,653,652,-1,27,29
250,405d0dc8-3494-4b2b-a840-e2720211084a,36721892,3900,2139,686,1453,28,29
250,405d0dc8-3494-4b2b-a840-e2720211084a,36721892,3900,2235,2163,72,29,29
250,405d0dc8-3494-4b2b-a840-e2720211084a,36721689,6852,539,4,535,0,18
250,405d0dc8-3494-4b2b-a840-e2720211084a,36721689,6852,1017,559,458,7,18
250,405d0dc8-3494-4b2b-a840-e2720211084a,36721689,6852,1531,1034,497,8,18
250,405d0dc8-3494-4b2b-a840-e2720211084a,36721689,6852,1594,1544,50,9,18
250,405d0dc8-3494-4b2b-a840-e2720211084a,36721689,6852,2215,1598,617,10,18
250,405d0dc8-3494-4b2b-a840-e2720211084a,36721689,6852,2766,2233,533,15,18
250,405d0dc8-3494-4b2b-a840-e2720211084a,36721689,6852,3310,2783,527,16,18
250,405d0dc8-3494-4b2b-a840-e2720211084a,36721689,6852,3598,3369,229,17,18
250,405d0dc8-3494-4b2b-a840-e2720211084a,36721689,6852,5187,3625,1562,18,18
250,608ae910-d7a0-4d8f-8d32-1e6e0ba04688,36719561,7998,238,1,237,0,8
250,608ae910-d7a0-4d8f-8d32-1e6e0ba04688,36719561,7998,403,239,164,3,8
250,608ae910-d7a0-4d8f-8d32-1e6e0ba04688,36719561,7998,557,424,133,4,8
250,608ae910-d7a0-4d8f-8d32-1e6e0ba04688,36719561,7998,536,0,-536,8,8
260,2667fac6-1038-4547-b281-9fa41d6dd49f,36726880,4036,1122,20,1102,0,1
260,2667fac6-1038-4547-b281-9fa41d6dd49f,36726880,4036,1812,1136,676,1,1
261,f60b1224-8ec2-469f-818c-205edeb1f07c,36733209,5976,179,3,176,0,5
261,f60b1224-8ec2-469f-818c-205edeb1f07c,36733209,5976,704,183,521,1,5
261,f60b1224-8ec2-469f-818c-205edeb1f07c,36733209,5976,1075,726,349,2,5
261,f60b1224-8ec2-469f-818c-205edeb1f07c,36733209,5976,2084,1090,994,3,5
261,f60b1224-8ec2-469f-818c-205edeb1f07c,36733209,5976,3541,2111,1430,4,5
261,f60b1224-8ec2-469f-818c-205edeb1f07c,36733209,5976,3920,3557,363,5,5
261,f60b1224-8ec2-469f-818c-205edeb1f07c,36701515,8200,1016,26,990,0,2
261,f60b1224-8ec2-469f-818c-205edeb1f07c,36701515,8200,1718,1038,680,1,2
261,f60b1224-8ec2-469f-818c-205edeb1f07c,36701515,8200,1721,0,-1721,2,2
250,64a43d8a-4b67-42b0-9f59-ac8a1bb1c684,36736571,5079,502,20,482,0,8
250,64a43d8a-4b67-42b0-9f59-ac8a1bb1c684,36736571,5079,754,513,241,1,8
250,64a43d8a-4b67-42b0-9f59-ac8a1bb1c684,36736571,5079,732,37,-695,2,8
250,64a43d8a-4b67-42b0-9f59-ac8a1bb1c684,36736571,5079,870,38,832,3,8
250,64a43d8a-4b67-42b0-9f59-ac8a1bb1c684,36736571,5079,1392,872,520,4,8
250,64a43d8a-4b67-42b0-9f59-ac8a1bb1c684,36736571,5079,1716,1413,303,5,8
250,64a43d8a-4b67-42b0-9f59-ac8a1bb1c684,36736571,5079,2289,1732,557,6,8
250,64a43d8a-4b67-42b0-9f59-ac8a1bb1c684,36736571,5079,3006,2298,708,7,8
250,64a43d8a-4b67-42b0-9f59-ac8a1bb1c684,36736571,5079,3414,3010,404,8,8
261,009b8175-f1ca-4f76-be13-5673098f2d14,36736571,8460,263,9,254,0,17
261,009b8175-f1ca-4f76-be13-5673098f2d14,36736571,8460,890,274,616,1,17
261,009b8175-f1ca-4f76-be13-5673098f2d14,36736571,8460,1440,931,509,2,17
261,009b8175-f1ca-4f76-be13-5673098f2d14,36736571,8460,1155,856,-299,3,17
261,009b8175-f1ca-4f76-be13-5673098f2d14,36736571,8460,2323,878,1445,14,17
261,009b8175-f1ca-4f76-be13-5673098f2d14,36736571,8460,3166,2352,814,15,17
261,009b8175-f1ca-4f76-be13-5673098f2d14,36736571,8460,4346,3248,1098,16,17
261,009b8175-f1ca-4f76-be13-5673098f2d14,36736571,8460,6404,4465,1939,17,17
261,009b8175-f1ca-4f76-be13-5673098f2d14,36726095,10880,348,22,326,0,45
261,009b8175-f1ca-4f76-be13-5673098f2d14,36726095,10880,572,352,220,1,45
261,009b8175-f1ca-4f76-be13-5673098f2d14,36726095,10880,1410,595,815,4,45
261,009b8175-f1ca-4f76-be13-5673098f2d14,36726095,10880,1922,1462,460,5,45
261,009b8175-f1ca-4f76-be13-5673098f2d14,36726095,10880,3251,1925,1326,6,45
261,009b8175-f1ca-4f76-be13-5673098f2d14,36726095,10880,3528,3317,211,7,45
261,009b8175-f1ca-4f76-be13-5673098f2d14,36726095,10880,3449,3449,0,8,45
261,009b8175-f1ca-4f76-be13-5673098f2d14,36726095,10880,4084,3469,615,13,45
261,009b8175-f1ca-4f76-be13-5673098f2d14,36726095,10880,4678,4122,556,14,45
261,009b8175-f1ca-4f76-be13-5673098f2d14,36726095,10880,4725,4679,46,32,45
261,009b8175-f1ca-4f76-be13-5673098f2d14,36726095,10880,5118,4751,367,34,45
261,009b8175-f1ca-4f76-be13-5673098f2d14,36726095,10880,5559,5208,351,41,45
261,009b8175-f1ca-4f76-be13-5673098f2d14,36726095,10880,6384,5578,806,44,45
261,009b8175-f1ca-4f76-be13-5673098f2d14,36726095,10880,8824,6583,2241,45,45
261,009b8175-f1ca-4f76-be13-5673098f2d14,36723486,6104,249,28,221,0,19
261,009b8175-f1ca-4f76-be13-5673098f2d14,36723486,6104,964,264,700,1,19
261,009b8175-f1ca-4f76-be13-5673098f2d14,36723486,6104,1851,1023,828,2,19
261,009b8175-f1ca-4f76-be13-5673098f2d14,36723486,6104,2231,1858,373,3,19
261,009b8175-f1ca-4f76-be13-5673098f2d14,36723486,6104,2269,2239,30,4,19
261,009b8175-f1ca-4f76-be13-5673098f2d14,36723486,6104,2263,2224,-39,5,19
261,009b8175-f1ca-4f76-be13-5673098f2d14,36723486,6104,2207,2141,-66,6,19
261,009b8175-f1ca-4f76-be13-5673098f2d14,36723486,6104,2181,2150,31,7,19
261,009b8175-f1ca-4f76-be13-5673098f2d14,36723486,6104,2348,2182,166,8,19
261,009b8175-f1ca-4f76-be13-5673098f2d14,36723486,6104,2727,2349,378,9,19
261,009b8175-f1ca-4f76-be13-5673098f2d14,36723486,6104,2816,2729,87,10,19
261,009b8175-f1ca-4f76-be13-5673098f2d14,36723486,6104,2875,2818,57,11,19
261,009b8175-f1ca-4f76-be13-5673098f2d14,36723486,6104,3375,2877,498,12,19
261,009b8175-f1ca-4f76-be13-5673098f2d14,36723486,6104,3082,3046,36,13,19
261,009b8175-f1ca-4f76-be13-5673098f2d14,36723486,6104,3092,3080,12,14,19
261,009b8175-f1ca-4f76-be13-5673098f2d14,36723486,6104,3093,3093,0,15,19
261,009b8175-f1ca-4f76-be13-5673098f2d14,36723486,6104,3129,3094,35,16,19
261,009b8175-f1ca-4f76-be13-5673098f2d14,36723486,6104,3153,3130,23,18,19
261,009b8175-f1ca-4f76-be13-5673098f2d14,36723486,6104,4048,3158,890,19,19
261,009b8175-f1ca-4f76-be13-5673098f2d14,36734377,6072,510,19,491,0,2007
261,009b8175-f1ca-4f76-be13-5673098f2d14,36734377,6072,860,516,344,2,2007
261,009b8175-f1ca-4f76-be13-5673098f2d14,36734377,6072,846,237,-609,3,2007
261,009b8175-f1ca-4f76-be13-5673098f2d14,36734377,6072,29,10,19,15,2007
261,009b8175-f1ca-4f76-be13-5673098f2d14,36734377,6072,305,45,260,16,2007
261,009b8175-f1ca-4f76-be13-5673098f2d14,36734377,6072,689,318,371,17,2007
261,009b8175-f1ca-4f76-be13-5673098f2d14,36734377,6072,994,718,276,18,2007
261,009b8175-f1ca-4f76-be13-5673098f2d14,36734377,6072,1031,995,36,19,2007
261,009b8175-f1ca-4f76-be13-5673098f2d14,36734377,6072,1347,1038,309,22,2007
261,009b8175-f1ca-4f76-be13-5673098f2d14,36734377,6072,1368,1351,17,23,2007
261,009b8175-f1ca-4f76-be13-5673098f2d14,36734377,6072,1815,1373,442,33,2007
261,009b8175-f1ca-4f76-be13-5673098f2d14,36734377,6072,1758,1287,-471,38,2007
261,009b8175-f1ca-4f76-be13-5673098f2d14,36734377,6072,1263,1211,-52,39,2007
261,009b8175-f1ca-4f76-be13-5673098f2d14,36734377,6072,1586,1227,359,64,2007
261,009b8175-f1ca-4f76-be13-5673098f2d14,36734377,6072,1656,1601,55,65,2007
261,009b8175-f1ca-4f76-be13-5673098f2d14,36734377,6072,1918,1682,236,67,2007
261,009b8175-f1ca-4f76-be13-5673098f2d14,36734377,6072,2447,1943,504,77,2007
261,009b8175-f1ca-4f76-be13-5673098f2d14,36734377,6072,2573,2472,101,78,2007
261,009b8175-f1ca-4f76-be13-5673098f2d14,36734377,6072,3035,2609,426,82,2007
261,009b8175-f1ca-4f76-be13-5673098f2d14,36734377,6072,3211,3057,154,83,2007
261,009b8175-f1ca-4f76-be13-5673098f2d14,36734377,6072,3172,2820,-352,2004,2007
261,009b8175-f1ca-4f76-be13-5673098f2d14,36734377,6072,3138,0,-3138,2005,2007
261,009b8175-f1ca-4f76-be13-5673098f2d14,36734377,6072,4016,2,4014,2007,2007
261,80515f53-d41c-4e14-b249-683adddc657c,36742640,3424,50,0,-50,0,21
261,80515f53-d41c-4e14-b249-683adddc657c,36742640,3424,407,2,405,12,21
261,80515f53-d41c-4e14-b249-683adddc657c,36742640,3424,977,431,546,15,21
261,80515f53-d41c-4e14-b249-683adddc657c,36742640,3424,1023,987,36,16,21
261,80515f53-d41c-4e14-b249-683adddc657c,36742640,3424,1027,1027,0,17,21
261,80515f53-d41c-4e14-b249-683adddc657c,36742640,3424,1368,1061,307,18,21
261,80515f53-d41c-4e14-b249-683adddc657c,36742640,3424,1368,790,578,21,21
261,80515f53-d41c-4e14-b249-683adddc657c,36738049,5772,313,27,286,0,69
261,80515f53-d41c-4e14-b249-683adddc657c,36738049,5772,345,322,23,1,69
261,80515f53-d41c-4e14-b249-683adddc657c,36738049,5772,844,352,492,12,69
261,80515f53-d41c-4e14-b249-683adddc657c,36738049,5772,1210,872,338,19,69
261,80515f53-d41c-4e14-b249-683adddc657c,36738049,5772,1698,1225,473,26,69
261,80515f53-d41c-4e14-b249-683adddc657c,36738049,5772,2262,1721,541,29,69
261,80515f53-d41c-4e14-b249-683adddc657c,36738049,5772,3100,2335,765,30,69
261,80515f53-d41c-4e14-b249-683adddc657c,36738049,5772,3371,3102,269,54,69
261,80515f53-d41c-4e14-b249-683adddc657c,36738049,5772,3372,3372,0,55,69
261,80515f53-d41c-4e14-b249-683adddc657c,36738049,5772,3716,3377,339,58,69
261,80515f53-d41c-4e14-b249-683adddc657c,36738049,5772,3716,3478,238,69,69
261,80515f53-d41c-4e14-b249-683adddc657c,36718347,6480,504,16,488,0,25
261,80515f53-d41c-4e14-b249-683adddc657c,36718347,6480,1082,527,555,4,25
261,80515f53-d41c-4e14-b249-683adddc657c,36718347,6480,1442,1098,344,5,25
261,80515f53-d41c-4e14-b249-683adddc657c,36718347,6480,1493,1455,38,6,25
261,80515f53-d41c-4e14-b249-683adddc657c,36718347,6480,2321,1498,823,7,25
261,80515f53-d41c-4e14-b249-683adddc657c,36718347,6480,3129,2357,772,8,25
261,80515f53-d41c-4e14-b249-683adddc657c,36718347,6480,3502,3176,326,9,25
261,80515f53-d41c-4e14-b249-683adddc657c,36718347,6480,3560,3515,45,10,25
261,80515f53-d41c-4e14-b249-683adddc657c,36718347,6480,3968,3567,401,16,25
261,80515f53-d41c-4e14-b249-683adddc657c,36718347,6480,3998,3977,21,17,25
261,80515f53-d41c-4e14-b249-683adddc657c,36718347,6480,4246,4026,220,18,25
261,80515f53-d41c-4e14-b249-683adddc657c,36718347,6480,4424,4259,165,25,25
261,80515f53-d41c-4e14-b249-683adddc657c,36732336,6820,310,13,297,0,40
261,80515f53-d41c-4e14-b249-683adddc657c,36732336,6820,315,312,3,1,40
261,80515f53-d41c-4e14-b249-683adddc657c,36732336,6820,493,320,173,10,40
261,80515f53-d41c-4e14-b249-683adddc657c,36732336,6820,622,513,109,11,40
261,80515f53-d41c-4e14-b249-683adddc657c,36732336,6820,1719,644,1075,12,40
261,80515f53-d41c-4e14-b249-683adddc657c,36732336,6820,2945,1776,1169,35,40
261,80515f53-d41c-4e14-b249-683adddc657c,36732336,6820,3449,2981,468,36,40
261,80515f53-d41c-4e14-b249-683adddc657c,36732336,6820,4764,3499,1265,37,40
261,80515f53-d41c-4e14-b249-683adddc657c,36732336,6820,4754,4538,-216,40,40
261,80515f53-d41c-4e14-b249-683adddc657c,36724562,6404,370,14,356,0,89
261,80515f53-d41c-4e14-b249-683adddc657c,36724562,6404,718,379,339,9,89
261,80515f53-d41c-4e14-b249-683adddc657c,36724562,6404,756,729,27,10,89
261,80515f53-d41c-4e14-b249-683adddc657c,36724562,6404,1399,801,598,11,89
261,80515f53-d41c-4e14-b249-683adddc657c,36724562,6404,1432,1407,25,12,89
261,80515f53-d41c-4e14-b249-683adddc657c,36724562,6404,1524,1452,72,25,89
261,80515f53-d41c-4e14-b249-683adddc657c,36724562,6404,1826,1556,270,26,89
261,80515f53-d41c-4e14-b249-683adddc657c,36724562,6404,2054,1832,222,28,89
261,80515f53-d41c-4e14-b249-683adddc657c,36724562,6404,2646,2069,577,29,89
261,80515f53-d41c-4e14-b249-683adddc657c,36724562,6404,2685,2654,31,30,89
261,80515f53-d41c-4e14-b249-683adddc657c,36724562,6404,3581,2703,878,35,89
261,80515f53-d41c-4e14-b249-683adddc657c,36724562,6404,3566,3472,-94,37,89
261,80515f53-d41c-4e14-b249-683adddc657c,36724562,6404,3504,3498,6,38,89
261,80515f53-d41c-4e14-b249-683adddc657c,36724562,6404,4272,3519,753,59,89
261,80515f53-d41c-4e14-b249-683adddc657c,36724562,6404,4285,4276,9,60,89
261,80515f53-d41c-4e14-b249-683adddc657c,36724562,6404,4348,4296,52,65,89
261,80515f53-d41c-4e14-b249-683adddc657c,36724562,6404,4304,2935,-1369,82,89
261,80515f53-d41c-4e14-b249-683adddc657c,36724562,6404,4348,2951,1397,83,89
261,80515f53-d41c-4e14-b249-683adddc657c,36724562,6404,4331,4133,-198,89,89
261,80515f53-d41c-4e14-b249-683adddc657c,36731596,5556,586,24,562,0,36
261,80515f53-d41c-4e14-b249-683adddc657c,36731596,5556,1012,626,386,1,36
261,80515f53-d41c-4e14-b249-683adddc657c,36731596,5556,1593,1016,577,4,36
261,80515f53-d41c-4e14-b249-683adddc657c,36731596,5556,2174,1610,564,7,36
261,80515f53-d41c-4e14-b249-683adddc657c,36731596,5556,2559,2175,384,12,36
261,80515f53-d41c-4e14-b249-683adddc657c,36731596,5556,3157,2603,554,13,36
261,80515f53-d41c-4e14-b249-683adddc657c,36731596,5556,3500,3163,337,15,36
261,80515f53-d41c-4e14-b249-683adddc657c,36731596,5556,3497,2995,-502,26,36
261,80515f53-d41c-4e14-b249-683adddc657c,36731596,5556,2978,2876,-102,27,36
261,80515f53-d41c-4e14-b249-683adddc657c,36731596,5556,2870,2637,-233,33,36
261,80515f53-d41c-4e14-b249-683adddc657c,36731596,5556,2608,1232,-1376,35,36
261,80515f53-d41c-4e14-b249-683adddc657c,36731596,5556,1164,0,-1164,36,36
261,20ddbde0-96ca-4340-9961-0640f3795f87,36746763,7292,579,44,535,0,2
261,20ddbde0-96ca-4340-9961-0640f3795f87,36746763,7292,1594,645,949,1,2
261,20ddbde0-96ca-4340-9961-0640f3795f87,36746763,7292,5236,1638,3598,2,2
261,20ddbde0-96ca-4340-9961-0640f3795f87,36746094,10520,117,8,109,0,139
261,20ddbde0-96ca-4340-9961-0640f3795f87,36746094,10520,545,126,419,1,139
261,20ddbde0-96ca-4340-9961-0640f3795f87,36746094,10520,802,549,253,2,139
261,20ddbde0-96ca-4340-9961-0640f3795f87,36746094,10520,1103,834,269,3,139
261,20ddbde0-96ca-4340-9961-0640f3795f87,36746094,10520,1477,1124,353,7,139
261,20ddbde0-96ca-4340-9961-0640f3795f87,36746094,10520,1573,1480,93,10,139
261,20ddbde0-96ca-4340-9961-0640f3795f87,36746094,10520,1750,1575,175,11,139
261,20ddbde0-96ca-4340-9961-0640f3795f87,36746094,10520,1854,1759,95,15,139
261,20ddbde0-96ca-4340-9961-0640f3795f87,36746094,10520,2040,1855,185,16,139
261,20ddbde0-96ca-4340-9961-0640f3795f87,36746094,10520,2557,2074,483,18,139
261,20ddbde0-96ca-4340-9961-0640f3795f87,36746094,10520,5217,2621,2596,19,139
261,20ddbde0-96ca-4340-9961-0640f3795f87,36746094,10520,5784,5261,523,20,139
261,20ddbde0-96ca-4340-9961-0640f3795f87,36746094,10520,6715,5846,869,33,139
261,20ddbde0-96ca-4340-9961-0640f3795f87,36746094,10520,7442,6472,-970,34,139
261,20ddbde0-96ca-4340-9961-0640f3795f87,36746094,10520,7031,6560,471,35,139
261,20ddbde0-96ca-4340-9961-0640f3795f87,36746094,10520,6977,6441,-536,138,139
261,20ddbde0-96ca-4340-9961-0640f3795f87,36746094,10520,6404,6091,-313,139,139
261,46b26fe9-956b-4b8c-b7cb-2c56fbaa4ce4,36744470,6944,622,29,593,0,0
250,275b62cf-0d89-44d2-b479-12bcac4c8d09,36744925,4839,60,1,59,0,57
250,275b62cf-0d89-44d2-b479-12bcac4c8d09,36744925,4839,153,62,91,1,57
250,275b62cf-0d89-44d2-b479-12bcac4c8d09,36744925,4839,190,154,36,2,57
250,275b62cf-0d89-44d2-b479-12bcac4c8d09,36744925,4839,413,195,218,3,57
250,275b62cf-0d89-44d2-b479-12bcac4c8d09,36744925,4839,745,424,321,11,57
250,275b62cf-0d89-44d2-b479-12bcac4c8d09,36744925,4839,1436,748,688,14,57
250,275b62cf-0d89-44d2-b479-12bcac4c8d09,36744925,4839,1473,1443,30,15,57
250,275b62cf-0d89-44d2-b479-12bcac4c8d09,36744925,4839,1755,1477,278,19,57
250,275b62cf-0d89-44d2-b479-12bcac4c8d09,36744925,4839,1783,1761,22,20,57
250,275b62cf-0d89-44d2-b479-12bcac4c8d09,36744925,4839,2077,1794,283,28,57
250,275b62cf-0d89-44d2-b479-12bcac4c8d09,36744925,4839,2120,2082,38,29,57
250,275b62cf-0d89-44d2-b479-12bcac4c8d09,36744925,4839,2383,2123,260,35,57
250,275b62cf-0d89-44d2-b479-12bcac4c8d09,36744925,4839,2404,2385,19,36,57
250,275b62cf-0d89-44d2-b479-12bcac4c8d09,36744925,4839,2447,2408,39,43,57
250,275b62cf-0d89-44d2-b479-12bcac4c8d09,36744925,4839,2849,2463,386,44,57
250,275b62cf-0d89-44d2-b479-12bcac4c8d09,36744925,4839,3174,2851,323,45,57
250,275b62cf-0d89-44d2-b479-12bcac4c8d09,36744925,4839,3156,2869,-287,56,57
250,275b62cf-0d89-44d2-b479-12bcac4c8d09,36744925,4839,2867,2866,-1,57,57
250,275b62cf-0d89-44d2-b479-12bcac4c8d09,36744461,3492,64,4,60,0,36
250,275b62cf-0d89-44d2-b479-12bcac4c8d09,36744461,3492,296,86,210,1,36
250,275b62cf-0d89-44d2-b479-12bcac4c8d09,36744461,3492,496,316,180,12,36
250,275b62cf-0d89-44d2-b479-12bcac4c8d09,36744461,3492,647,522,125,13,36
250,275b62cf-0d89-44d2-b479-12bcac4c8d09,36744461,3492,795,650,145,14,36
250,275b62cf-0d89-44d2-b479-12bcac4c8d09,36744461,3492,1181,808,373,22,36
250,275b62cf-0d89-44d2-b479-12bcac4c8d09,36744461,3492,1465,1182,283,30,36
250,275b62cf-0d89-44d2-b479-12bcac4c8d09,36744461,3492,1570,1486,84,31,36
250,275b62cf-0d89-44d2-b479-12bcac4c8d09,36744461,3492,1827,1576,251,36,36
261,945a3c8c-0d26-41d2-837a-95de47317190,36744925,6452,219,12,207,0,8
261,945a3c8c-0d26-41d2-837a-95de47317190,36744925,6452,678,222,456,1,8
261,945a3c8c-0d26-41d2-837a-95de47317190,36744925,6452,1123,696,427,3,8
261,945a3c8c-0d26-41d2-837a-95de47317190,36744925,6452,1674,1168,506,4,8
261,945a3c8c-0d26-41d2-837a-95de47317190,36744925,6452,2280,1679,601,5,8
261,945a3c8c-0d26-41d2-837a-95de47317190,36744925,6452,3009,2289,720,7,8
261,945a3c8c-0d26-41d2-837a-95de47317190,36744925,6452,4396,3022,1374,8,8
250,f0dc25db-45d0-4305-9ef0-29cd85ea22ca,36744470,5208,903,4,899,0,26
250,f0dc25db-45d0-4305-9ef0-29cd85ea22ca,36744470,5208,957,912,45,1,26
250,f0dc25db-45d0-4305-9ef0-29cd85ea22ca,36744470,5208,940,745,-195,5,26
250,f0dc25db-45d0-4305-9ef0-29cd85ea22ca,36744470,5208,739,601,-138,6,26
250,f0dc25db-45d0-4305-9ef0-29cd85ea22ca,36744470,5208,600,569,-31,7,26
250,f0dc25db-45d0-4305-9ef0-29cd85ea22ca,36744470,5208,1082,584,498,10,26
250,f0dc25db-45d0-4305-9ef0-29cd85ea22ca,36744470,5208,1109,1087,22,11,26
250,f0dc25db-45d0-4305-9ef0-29cd85ea22ca,36744470,5208,1571,1119,452,12,26
250,f0dc25db-45d0-4305-9ef0-29cd85ea22ca,36744470,5208,1601,1577,24,13,26
250,f0dc25db-45d0-4305-9ef0-29cd85ea22ca,36744470,5208,1972,1605,367,14,26
250,f0dc25db-45d0-4305-9ef0-29cd85ea22ca,36744470,5208,1974,1973,1,15,26
250,f0dc25db-45d0-4305-9ef0-29cd85ea22ca,36744470,5208,2201,1975,226,17,26
250,f0dc25db-45d0-4305-9ef0-29cd85ea22ca,36744470,5208,2470,2246,224,18,26
250,f0dc25db-45d0-4305-9ef0-29cd85ea22ca,36744470,5208,2718,2475,243,19,26
250,f0dc25db-45d0-4305-9ef0-29cd85ea22ca,36744470,5208,3051,2723,328,20,26
250,f0dc25db-45d0-4305-9ef0-29cd85ea22ca,36744470,5208,3058,3054,4,21,26
250,f0dc25db-45d0-4305-9ef0-29cd85ea22ca,36744470,5208,3450,3062,388,24,26
250,f0dc25db-45d0-4305-9ef0-29cd85ea22ca,36744470,5208,3543,3459,84,25,26
250,f0dc25db-45d0-4305-9ef0-29cd85ea22ca,36744470,5208,3542,3542,0,26,26
261,a7871fd5-6745-4fab-a6b5-e3726e4ecaa3,36754146,5088,1150,6,1144,0,3
261,a7871fd5-6745-4fab-a6b5-e3726e4ecaa3,36754146,5088,3032,1221,1811,1,3
261,a7871fd5-6745-4fab-a6b5-e3726e4ecaa3,36754146,5088,3028,2032,-996,2,3
261,a7871fd5-6745-4fab-a6b5-e3726e4ecaa3,36754146,5088,1873,0,-1873,3,3
261,a7871fd5-6745-4fab-a6b5-e3726e4ecaa3,36754009,4156,151,21,130,0,26
261,a7871fd5-6745-4fab-a6b5-e3726e4ecaa3,36754009,4156,221,159,62,1,26
261,a7871fd5-6745-4fab-a6b5-e3726e4ecaa3,36754009,4156,253,222,31,2,26
261,a7871fd5-6745-4fab-a6b5-e3726e4ecaa3,36754009,4156,299,254,45,3,26
261,a7871fd5-6745-4fab-a6b5-e3726e4ecaa3,36754009,4156,372,300,72,4,26
261,a7871fd5-6745-4fab-a6b5-e3726e4ecaa3,36754009,4156,491,374,117,5,26
261,a7871fd5-6745-4fab-a6b5-e3726e4ecaa3,36754009,4156,762,521,241,6,26
261,a7871fd5-6745-4fab-a6b5-e3726e4ecaa3,36754009,4156,824,772,52,7,26
261,a7871fd5-6745-4fab-a6b5-e3726e4ecaa3,36754009,4156,1087,826,261,11,26
261,a7871fd5-6745-4fab-a6b5-e3726e4ecaa3,36754009,4156,1139,1093,46,12,26
261,a7871fd5-6745-4fab-a6b5-e3726e4ecaa3,36754009,4156,1228,1147,81,13,26
261,a7871fd5-6745-4fab-a6b5-e3726e4ecaa3,36754009,4156,1367,1243,124,14,26
261,a7871fd5-6745-4fab-a6b5-e3726e4ecaa3,36754009,4156,1461,1381,80,15,26
261,a7871fd5-6745-4fab-a6b5-e3726e4ecaa3,36754009,4156,1781,1464,317,16,26
261,a7871fd5-6745-4fab-a6b5-e3726e4ecaa3,36754009,4156,2070,1815,255,17,26
261,a7871fd5-6745-4fab-a6b5-e3726e4ecaa3,36754009,4156,2100,2073,27,18,26
261,a7871fd5-6745-4fab-a6b5-e3726e4ecaa3,36754009,4156,2100,2099,1,19,26
261,a7871fd5-6745-4fab-a6b5-e3726e4ecaa3,36754009,4156,2099,2099,0,20,26
261,a7871fd5-6745-4fab-a6b5-e3726e4ecaa3,36754009,4156,2100,2100,0,24,26
261,a7871fd5-6745-4fab-a6b5-e3726e4ecaa3,36754009,4156,2053,1641,-412,26,26
250,d08962da-27cc-45f8-a21e-c9fb8dcb8fcb,36756379,3441,368,12,356,0,14
250,d08962da-27cc-45f8-a21e-c9fb8dcb8fcb,36756379,3441,819,461,358,5,14
250,d08962da-27cc-45f8-a21e-c9fb8dcb8fcb,36756379,3441,1179,823,356,6,14
250,d08962da-27cc-45f8-a21e-c9fb8dcb8fcb,36756379,3441,1193,1180,13,7,14
250,d08962da-27cc-45f8-a21e-c9fb8dcb8fcb,36756379,3441,1302,1197,105,8,14
250,d08962da-27cc-45f8-a21e-c9fb8dcb8fcb,36756379,3441,1702,1304,398,13,14
250,d08962da-27cc-45f8-a21e-c9fb8dcb8fcb,36756379,3441,1776,1713,63,14,14
250,f120f1a0-4ccc-4a44-9677-851b19723bda,36755495,9621,523,18,505,0,41
250,f120f1a0-4ccc-4a44-9677-851b19723bda,36755495,9621,447,115,-332,1,41
250,f120f1a0-4ccc-4a44-9677-851b19723bda,36755495,9621,491,122,369,2,41
250,f120f1a0-4ccc-4a44-9677-851b19723bda,36755495,9621,694,493,201,5,41
250,f120f1a0-4ccc-4a44-9677-851b19723bda,36755495,9621,759,695,64,6,41
250,f120f1a0-4ccc-4a44-9677-851b19723bda,36755495,9621,843,760,83,7,41
250,f120f1a0-4ccc-4a44-9677-851b19723bda,36755495,9621,891,845,46,8,41
250,f120f1a0-4ccc-4a44-9677-851b19723bda,36755495,9621,1183,900,283,14,41
250,f120f1a0-4ccc-4a44-9677-851b19723bda,36755495,9621,1202,1185,17,15,41
250,f120f1a0-4ccc-4a44-9677-851b19723bda,36755495,9621,1693,1206,487,21,41
250,f120f1a0-4ccc-4a44-9677-851b19723bda,36755495,9621,1769,1694,75,22,41
250,f120f1a0-4ccc-4a44-9677-851b19723bda,36755495,9621,2198,1787,411,23,41
250,f120f1a0-4ccc-4a44-9677-851b19723bda,36755495,9621,2447,2217,230,25,41
250,f120f1a0-4ccc-4a44-9677-851b19723bda,36755495,9621,5053,2497,2556,41,41
259,09e5dbaf-a4b7-4e60-8790-4f2125bf59e3,36757060,4428,105,5,100,0,46
259,09e5dbaf-a4b7-4e60-8790-4f2125bf59e3,36757060,4428,110,107,3,1,46
259,09e5dbaf-a4b7-4e60-8790-4f2125bf59e3,36757060,4428,311,122,189,2,46
259,09e5dbaf-a4b7-4e60-8790-4f2125bf59e3,36757060,4428,398,323,75,3,46
259,09e5dbaf-a4b7-4e60-8790-4f2125bf59e3,36757060,4428,477,399,78,4,46
259,09e5dbaf-a4b7-4e60-8790-4f2125bf59e3,36757060,4428,938,481,457,5,46
259,09e5dbaf-a4b7-4e60-8790-4f2125bf59e3,36757060,4428,942,939,3,6,46
259,09e5dbaf-a4b7-4e60-8790-4f2125bf59e3,36757060,4428,996,944,52,10,46
259,09e5dbaf-a4b7-4e60-8790-4f2125bf59e3,36757060,4428,1128,997,131,11,46
259,09e5dbaf-a4b7-4e60-8790-4f2125bf59e3,36757060,4428,1184,1133,51,12,46
259,09e5dbaf-a4b7-4e60-8790-4f2125bf59e3,36757060,4428,1191,1184,7,13,46
259,09e5dbaf-a4b7-4e60-8790-4f2125bf59e3,36757060,4428,1272,1192,80,15,46
259,09e5dbaf-a4b7-4e60-8790-4f2125bf59e3,36757060,4428,1352,1278,74,16,46
259,09e5dbaf-a4b7-4e60-8790-4f2125bf59e3,36757060,4428,1358,1355,3,17,46
259,09e5dbaf-a4b7-4e60-8790-4f2125bf59e3,36757060,4428,1692,1394,298,25,46
259,09e5dbaf-a4b7-4e60-8790-4f2125bf59e3,36757060,4428,1693,1692,-1,26,46
259,09e5dbaf-a4b7-4e60-8790-4f2125bf59e3,36757060,4428,1846,1707,139,30,46
259,09e5dbaf-a4b7-4e60-8790-4f2125bf59e3,36757060,4428,2477,1854,623,31,46
259,09e5dbaf-a4b7-4e60-8790-4f2125bf59e3,36757060,4428,2498,2482,16,32,46
259,09e5dbaf-a4b7-4e60-8790-4f2125bf59e3,36757060,4428,2687,2523,164,34,46
259,09e5dbaf-a4b7-4e60-8790-4f2125bf59e3,36757060,4428,2921,2699,222,35,46
259,09e5dbaf-a4b7-4e60-8790-4f2125bf59e3,36757060,4428,3318,2923,395,40,46
259,09e5dbaf-a4b7-4e60-8790-4f2125bf59e3,36757060,4428,3318,3317,1,46,46
259,09e5dbaf-a4b7-4e60-8790-4f2125bf59e3,36756917,3210,56,1,55,0,45
259,09e5dbaf-a4b7-4e60-8790-4f2125bf59e3,36756917,3210,112,57,55,1,45
259,09e5dbaf-a4b7-4e60-8790-4f2125bf59e3,36756917,3210,145,113,32,13,45
259,09e5dbaf-a4b7-4e60-8790-4f2125bf59e3,36756917,3210,164,146,18,14,45
259,09e5dbaf-a4b7-4e60-8790-4f2125bf59e3,36756917,3210,204,168,36,15,45
259,09e5dbaf-a4b7-4e60-8790-4f2125bf59e3,36756917,3210,201,189,-12,16,45
259,09e5dbaf-a4b7-4e60-8790-4f2125bf59e3,36756917,3210,251,199,52,17,45
259,09e5dbaf-a4b7-4e60-8790-4f2125bf59e3,36756917,3210,265,253,12,18,45
259,09e5dbaf-a4b7-4e60-8790-4f2125bf59e3,36756917,3210,482,266,216,19,45
259,09e5dbaf-a4b7-4e60-8790-4f2125bf59e3,36756917,3210,484,483,-1,20,45
259,09e5dbaf-a4b7-4e60-8790-4f2125bf59e3,36756917,3210,484,483,1,20,45
259,09e5dbaf-a4b7-4e60-8790-4f2125bf59e3,36756917,3210,609,491,118,23,45
259,09e5dbaf-a4b7-4e60-8790-4f2125bf59e3,36756917,3210,1104,623,481,26,45
259,09e5dbaf-a4b7-4e60-8790-4f2125bf59e3,36756917,3210,1159,1106,53,27,45
259,09e5dbaf-a4b7-4e60-8790-4f2125bf59e3,36756917,3210,2100,1174,926,34,45
259,09e5dbaf-a4b7-4e60-8790-4f2125bf59e3,36756917,3210,2070,2058,-12,35,45
259,09e5dbaf-a4b7-4e60-8790-4f2125bf59e3,36756917,3210,2078,2061,17,43,45
259,09e5dbaf-a4b7-4e60-8790-4f2125bf59e3,36756917,3210,2100,2084,16,45,45
259,09e5dbaf-a4b7-4e60-8790-4f2125bf59e3,36756723,2706,44,11,33,0,33
259,09e5dbaf-a4b7-4e60-8790-4f2125bf59e3,36756723,2706,70,45,25,1,33
259,09e5dbaf-a4b7-4e60-8790-4f2125bf59e3,36756723,2706,115,72,43,4,33
259,09e5dbaf-a4b7-4e60-8790-4f2125bf59e3,36756723,2706,196,118,78,5,33
259,09e5dbaf-a4b7-4e60-8790-4f2125bf59e3,36756723,2706,242,198,44,6,33
259,09e5dbaf-a4b7-4e60-8790-4f2125bf59e3,36756723,2706,271,243,28,7,33
259,09e5dbaf-a4b7-4e60-8790-4f2125bf59e3,36756723,2706,278,272,6,8,33
259,09e5dbaf-a4b7-4e60-8790-4f2125bf59e3,36756723,2706,293,283,10,9,33
259,09e5dbaf-a4b7-4e60-8790-4f2125bf59e3,36756723,2706,345,295,50,12,33
259,09e5dbaf-a4b7-4e60-8790-4f2125bf59e3,36756723,2706,385,346,39,13,33
259,09e5dbaf-a4b7-4e60-8790-4f2125bf59e3,36756723,2706,444,389,55,15,33
259,09e5dbaf-a4b7-4e60-8790-4f2125bf59e3,36756723,2706,469,446,23,16,33
259,09e5dbaf-a4b7-4e60-8790-4f2125bf59e3,36756723,2706,509,472,37,17,33
259,09e5dbaf-a4b7-4e60-8790-4f2125bf59e3,36756723,2706,515,511,4,18,33
259,09e5dbaf-a4b7-4e60-8790-4f2125bf59e3,36756723,2706,656,519,137,19,33
259,09e5dbaf-a4b7-4e60-8790-4f2125bf59e3,36756723,2706,758,666,92,20,33
259,09e5dbaf-a4b7-4e60-8790-4f2125bf59e3,36756723,2706,840,759,81,24,33
259,09e5dbaf-a4b7-4e60-8790-4f2125bf59e3,36756723,2706,922,851,71,25,33
259,09e5dbaf-a4b7-4e60-8790-4f2125bf59e3,36756723,2706,970,936,34,28,33
259,09e5dbaf-a4b7-4e60-8790-4f2125bf59e3,36756723,2706,1210,984,226,29,33
259,09e5dbaf-a4b7-4e60-8790-4f2125bf59e3,36756723,2706,1211,1211,0,30,33
259,09e5dbaf-a4b7-4e60-8790-4f2125bf59e3,36756723,2706,1596,1223,373,33,33
259,09e5dbaf-a4b7-4e60-8790-4f2125bf59e3,36756848,1808,36,1,35,0,22
259,09e5dbaf-a4b7-4e60-8790-4f2125bf59e3,36756848,1808,40,37,3,1,22
259,09e5dbaf-a4b7-4e60-8790-4f2125bf59e3,36756848,1808,120,41,79,6,22
259,09e5dbaf-a4b7-4e60-8790-4f2125bf59e3,36756848,1808,587,121,466,7,22
259,09e5dbaf-a4b7-4e60-8790-4f2125bf59e3,36756848,1808,608,591,17,8,22
259,09e5dbaf-a4b7-4e60-8790-4f2125bf59e3,36756848,1808,687,610,77,12,22
259,09e5dbaf-a4b7-4e60-8790-4f2125bf59e3,36756848,1808,698,698,0,13,22
259,09e5dbaf-a4b7-4e60-8790-4f2125bf59e3,36756848,1808,696,644,-52,18,22
259,09e5dbaf-a4b7-4e60-8790-4f2125bf59e3,36756848,1808,643,607,-36,19,22
259,09e5dbaf-a4b7-4e60-8790-4f2125bf59e3,36756848,1808,606,602,-4,20,22
259,09e5dbaf-a4b7-4e60-8790-4f2125bf59e3,36756848,1808,601,569,-32,22,22
259,09e5dbaf-a4b7-4e60-8790-4f2125bf59e3,36756848,1808,601,569,32,22,22
259,09e5dbaf-a4b7-4e60-8790-4f2125bf59e3,36754206,3078,464,6,458,0,4
259,09e5dbaf-a4b7-4e60-8790-4f2125bf59e3,36754206,3078,984,487,497,1,4
259,09e5dbaf-a4b7-4e60-8790-4f2125bf59e3,36754206,3078,1132,986,146,2,4
259,09e5dbaf-a4b7-4e60-8790-4f2125bf59e3,36754206,3078,1717,1180,537,3,4
259,09e5dbaf-a4b7-4e60-8790-4f2125bf59e3,36754206,3078,1968,1738,230,4,4
261,2a13ccc4-8935-4375-b340-d04f927884ad,36756917,6420,545,27,518,0,10
261,2a13ccc4-8935-4375-b340-d04f927884ad,36756917,6420,951,570,381,9,10
261,2a13ccc4-8935-4375-b340-d04f927884ad,36756917,6420,1560,954,606,10,10
261,a5559b7c-f8b9-4232-bba1-5af2203097f8,36757456,14108,615,8,607,0,28
261,a5559b7c-f8b9-4232-bba1-5af2203097f8,36757456,14108,658,621,37,1,28
261,a5559b7c-f8b9-4232-bba1-5af2203097f8,36757456,14108,1691,694,997,17,28
261,a5559b7c-f8b9-4232-bba1-5af2203097f8,36757456,14108,2151,1696,455,18,28
261,a5559b7c-f8b9-4232-bba1-5af2203097f8,36757456,14108,4265,2152,2113,19,28
261,a5559b7c-f8b9-4232-bba1-5af2203097f8,36757456,14108,7030,4267,2763,20,28
261,a5559b7c-f8b9-4232-bba1-5af2203097f8,36757456,14108,11466,7052,4414,21,28
261,a5559b7c-f8b9-4232-bba1-5af2203097f8,36757456,14108,11523,11475,48,22,28
261,a5559b7c-f8b9-4232-bba1-5af2203097f8,36757456,14108,12052,11572,480,26,28
261,a5559b7c-f8b9-4232-bba1-5af2203097f8,36757456,14108,12041,6867,-5174,27,28
261,a5559b7c-f8b9-4232-bba1-5af2203097f8,36757456,14108,6526,477,-6049,28,28
250,fe1408ac-5f84-4edd-9507-a42cd1d195d2,36756723,4059,490,31,459,0,11
250,fe1408ac-5f84-4edd-9507-a42cd1d195d2,36756723,4059,498,492,6,1,11
250,fe1408ac-5f84-4edd-9507-a42cd1d195d2,36756723,4059,948,500,448,5,11
250,fe1408ac-5f84-4edd-9507-a42cd1d195d2,36756723,4059,1566,962,604,9,11
250,fe1408ac-5f84-4edd-9507-a42cd1d195d2,36756723,4059,2197,1580,617,10,11
250,fe1408ac-5f84-4edd-9507-a42cd1d195d2,36756723,4059,2394,2202,192,11,11
127,900ccc86-0b34-44f1-8f2f-055ac12879fd,36744470,4046,6,6,0,0,13071
127,900ccc86-0b34-44f1-8f2f-055ac12879fd,36744470,4046,295,32,263,1,13071
127,900ccc86-0b34-44f1-8f2f-055ac12879fd,36744470,4046,248,0,-248,3,13071
127,900ccc86-0b34-44f1-8f2f-055ac12879fd,36744470,4046,307,8,299,4,13071
127,900ccc86-0b34-44f1-8f2f-055ac12879fd,36744470,4046,679,317,362,5,13071
127,900ccc86-0b34-44f1-8f2f-055ac12879fd,36744470,4046,845,683,162,9,13071
127,900ccc86-0b34-44f1-8f2f-055ac12879fd,36744470,4046,849,847,2,10,13071
127,900ccc86-0b34-44f1-8f2f-055ac12879fd,36744470,4046,1164,854,310,18,13071
127,900ccc86-0b34-44f1-8f2f-055ac12879fd,36744470,4046,1557,1170,387,28,13071
127,900ccc86-0b34-44f1-8f2f-055ac12879fd,36744470,4046,1632,1568,64,29,13071
127,900ccc86-0b34-44f1-8f2f-055ac12879fd,36744470,4046,1663,1636,27,41,13071
127,900ccc86-0b34-44f1-8f2f-055ac12879fd,36744470,4046,1852,1676,176,42,13071
127,900ccc86-0b34-44f1-8f2f-055ac12879fd,36744470,4046,2108,1859,249,48,13071
127,900ccc86-0b34-44f1-8f2f-055ac12879fd,36744470,4046,2110,2109,1,49,13071
127,900ccc86-0b34-44f1-8f2f-055ac12879fd,36744470,4046,2137,2112,25,55,13071
127,900ccc86-0b34-44f1-8f2f-055ac12879fd,36744470,4046,2421,2150,271,56,13071
127,900ccc86-0b34-44f1-8f2f-055ac12879fd,36744470,4046,2473,2434,39,57,13071
127,900ccc86-0b34-44f1-8f2f-055ac12879fd,36744470,4046,2402,2040,-362,13070,13071
127,900ccc86-0b34-44f1-8f2f-055ac12879fd,36744470,4046,2046,2043,3,13071,13071
250,c6e2a333-5be3-49ea-ad71-4d6d7650c361,36760859,4779,302,10,292,0,36
250,c6e2a333-5be3-49ea-ad71-4d6d7650c361,36760859,4779,725,381,344,1,36
250,c6e2a333-5be3-49ea-ad71-4d6d7650c361,36760859,4779,794,733,61,13,36
250,c6e2a333-5be3-49ea-ad71-4d6d7650c361,36760859,4779,970,798,172,14,36
250,c6e2a333-5be3-49ea-ad71-4d6d7650c361,36760859,4779,1200,983,217,15,36
250,c6e2a333-5be3-49ea-ad71-4d6d7650c361,36760859,4779,1602,1214,388,16,36
250,c6e2a333-5be3-49ea-ad71-4d6d7650c361,36760859,4779,1621,1606,15,17,36
250,c6e2a333-5be3-49ea-ad71-4d6d7650c361,36760859,4779,1818,1627,191,18,36
250,c6e2a333-5be3-49ea-ad71-4d6d7650c361,36760859,4779,2126,1823,303,19,36
250,c6e2a333-5be3-49ea-ad71-4d6d7650c361,36760859,4779,2834,2158,676,20,36
250,c6e2a333-5be3-49ea-ad71-4d6d7650c361,36760859,4779,3114,2846,268,31,36
250,c6e2a333-5be3-49ea-ad71-4d6d7650c361,36760859,4779,3108,2791,-317,36,36
250,e44e63dc-0d52-4745-a017-2523312d33b7,36763208,3255,507,28,479,0,3
250,e44e63dc-0d52-4745-a017-2523312d33b7,36763208,3255,1284,532,752,1,3
250,e44e63dc-0d52-4745-a017-2523312d33b7,36763208,3255,1590,1300,290,2,3
250,e44e63dc-0d52-4745-a017-2523312d33b7,36763208,3255,1590,1589,1,3,3
250,53b355d8-e501-47c2-a5b9-3aa72922386a,36763208,4473,236,8,228,0,106
250,53b355d8-e501-47c2-a5b9-3aa72922386a,36763208,4473,382,245,137,1,106
250,53b355d8-e501-47c2-a5b9-3aa72922386a,36763208,4473,1092,442,650,12,106
250,53b355d8-e501-47c2-a5b9-3aa72922386a,36763208,4473,1149,1107,42,13,106
250,53b355d8-e501-47c2-a5b9-3aa72922386a,36763208,4473,1493,1157,336,27,106
250,53b355d8-e501-47c2-a5b9-3aa72922386a,36763208,4473,1499,1496,3,28,106
250,53b355d8-e501-47c2-a5b9-3aa72922386a,36763208,4473,1999,1514,485,32,106
250,53b355d8-e501-47c2-a5b9-3aa72922386a,36763208,4473,2368,2004,364,47,106
250,53b355d8-e501-47c2-a5b9-3aa72922386a,36763208,4473,2747,2390,357,64,106
250,53b355d8-e501-47c2-a5b9-3aa72922386a,36763208,4473,2808,2808,0,77,106
250,53b355d8-e501-47c2-a5b9-3aa72922386a,36763208,4473,2795,2542,-253,93,106
250,53b355d8-e501-47c2-a5b9-3aa72922386a,36763208,4473,2522,2120,-402,106,106
261,4539e2e3-90e9-419b-acd1-1597fbe4f42d,36763572,6128,40,8,32,0,46
261,4539e2e3-90e9-419b-acd1-1597fbe4f42d,36763572,6128,283,52,231,4,46
261,4539e2e3-90e9-419b-acd1-1597fbe4f42d,36763572,6128,287,284,3,5,46
261,4539e2e3-90e9-419b-acd1-1597fbe4f42d,36763572,6128,630,317,313,6,46
261,4539e2e3-90e9-419b-acd1-1597fbe4f42d,36763572,6128,793,632,161,7,46
261,4539e2e3-90e9-419b-acd1-1597fbe4f42d,36763572,6128,1269,801,468,8,46
261,4539e2e3-90e9-419b-acd1-1597fbe4f42d,36763572,5316,199,44,155,24,46
261,4539e2e3-90e9-419b-acd1-1597fbe4f42d,36763572,6128,720,0,720,25,46
261,4539e2e3-90e9-419b-acd1-1597fbe4f42d,36763572,6128,1076,724,352,26,46
261,4539e2e3-90e9-419b-acd1-1597fbe4f42d,36763572,6128,1505,1084,421,27,46
261,4539e2e3-90e9-419b-acd1-1597fbe4f42d,36763572,6128,2078,1536,542,28,46
261,4539e2e3-90e9-419b-acd1-1597fbe4f42d,36763572,6128,2106,2087,19,29,46
261,4539e2e3-90e9-419b-acd1-1597fbe4f42d,36763572,6128,2390,2132,258,38,46
261,4539e2e3-90e9-419b-acd1-1597fbe4f42d,36763572,6128,2811,2397,414,39,46
261,4539e2e3-90e9-419b-acd1-1597fbe4f42d,36763572,6128,2844,2812,32,40,46
261,4539e2e3-90e9-419b-acd1-1597fbe4f42d,36763572,6128,3117,2866,251,43,46
261,4539e2e3-90e9-419b-acd1-1597fbe4f42d,36763572,6128,4072,3182,890,44,46
261,4539e2e3-90e9-419b-acd1-1597fbe4f42d,36763572,6128,4072,4071,1,46,46
261,4539e2e3-90e9-419b-acd1-1597fbe4f42d,36761497,5952,180,1,179,0,21
261,4539e2e3-90e9-419b-acd1-1597fbe4f42d,36761497,5952,193,181,12,1,21
261,4539e2e3-90e9-419b-acd1-1597fbe4f42d,36761497,5952,219,194,25,2,21
261,4539e2e3-90e9-419b-acd1-1597fbe4f42d,36761497,5952,254,220,34,3,21
261,4539e2e3-90e9-419b-acd1-1597fbe4f42d,36761497,5952,466,255,211,4,21
261,4539e2e3-90e9-419b-acd1-1597fbe4f42d,36761497,5952,782,480,302,5,21
261,4539e2e3-90e9-419b-acd1-1597fbe4f42d,36761497,5952,945,784,161,6,21
261,4539e2e3-90e9-419b-acd1-1597fbe4f42d,36761497,5952,1253,948,305,7,21
261,4539e2e3-90e9-419b-acd1-1597fbe4f42d,36761497,5952,1403,1254,149,8,21
261,4539e2e3-90e9-419b-acd1-1597fbe4f42d,36761497,5952,2164,1404,760,9,21
261,4539e2e3-90e9-419b-acd1-1597fbe4f42d,36761497,5952,2196,2171,25,10,21
261,4539e2e3-90e9-419b-acd1-1597fbe4f42d,36761497,5952,2350,2217,133,11,21
261,4539e2e3-90e9-419b-acd1-1597fbe4f42d,36761497,5952,2687,2395,292,15,21
261,4539e2e3-90e9-419b-acd1-1597fbe4f42d,36761497,5952,3374,2702,672,18,21
261,4539e2e3-90e9-419b-acd1-1597fbe4f42d,36761497,5952,3896,3388,508,19,21
261,4539e2e3-90e9-419b-acd1-1597fbe4f42d,36761497,5952,3854,0,-3854,21,21
261,4539e2e3-90e9-419b-acd1-1597fbe4f42d,36760985,6136,172,18,154,0,1
261,4539e2e3-90e9-419b-acd1-1597fbe4f42d,36760985,6136,171,0,-171,1,1
261,4539e2e3-90e9-419b-acd1-1597fbe4f42d,36763932,6684,659,13,646,0,31
261,4539e2e3-90e9-419b-acd1-1597fbe4f42d,36763932,6684,660,660,0,1,31
261,4539e2e3-90e9-419b-acd1-1597fbe4f42d,36763932,6684,933,665,268,6,31
261,4539e2e3-90e9-419b-acd1-1597fbe4f42d,36763932,6684,1141,936,205,7,31
261,4539e2e3-90e9-419b-acd1-1597fbe4f42d,36763932,6684,1547,1162,385,13,31
261,4539e2e3-90e9-419b-acd1-1597fbe4f42d,36763932,6684,1799,1579,220,18,31
261,4539e2e3-90e9-419b-acd1-1597fbe4f42d,36763932,6684,2081,1841,240,19,31
261,4539e2e3-90e9-419b-acd1-1597fbe4f42d,36763932,6684,2120,2089,31,20,31
261,4539e2e3-90e9-419b-acd1-1597fbe4f42d,36763932,6684,2340,2155,185,21,31
261,4539e2e3-90e9-419b-acd1-1597fbe4f42d,36763932,6684,2904,2355,549,27,31
261,4539e2e3-90e9-419b-acd1-1597fbe4f42d,36763932,6684,2896,2806,-90,28,31
261,4539e2e3-90e9-419b-acd1-1597fbe4f42d,36763932,6684,3518,2921,597,29,31
261,4539e2e3-90e9-419b-acd1-1597fbe4f42d,36763932,6684,3554,3526,28,30,31
261,4539e2e3-90e9-419b-acd1-1597fbe4f42d,36763932,6684,4628,3582,1046,31,31
261,4539e2e3-90e9-419b-acd1-1597fbe4f42d,36765143,7636,230,18,212,0,24
261,4539e2e3-90e9-419b-acd1-1597fbe4f42d,36765143,7636,388,233,155,1,24
261,4539e2e3-90e9-419b-acd1-1597fbe4f42d,36765143,7636,957,389,568,2,24
261,4539e2e3-90e9-419b-acd1-1597fbe4f42d,36765143,7636,1729,980,749,7,24
261,4539e2e3-90e9-419b-acd1-1597fbe4f42d,36765143,7636,1905,1750,155,8,24
261,4539e2e3-90e9-419b-acd1-1597fbe4f42d,36765143,7636,2061,1914,147,9,24
261,4539e2e3-90e9-419b-acd1-1597fbe4f42d,36765143,7636,4024,2104,1920,15,24
261,4539e2e3-90e9-419b-acd1-1597fbe4f42d,36765143,7636,4157,3119,-1038,16,24
261,4539e2e3-90e9-419b-acd1-1597fbe4f42d,36765143,7636,3421,3227,194,17,24
261,4539e2e3-90e9-419b-acd1-1597fbe4f42d,36765143,7636,3647,3431,216,18,24
261,4539e2e3-90e9-419b-acd1-1597fbe4f42d,36765143,7636,3837,3670,167,22,24
261,4539e2e3-90e9-419b-acd1-1597fbe4f42d,36765143,7636,5580,3916,1664,23,24
261,4539e2e3-90e9-419b-acd1-1597fbe4f42d,36765143,7636,5580,5579,1,24,24
261,4539e2e3-90e9-419b-acd1-1597fbe4f42d,36744925,6452,5,5,0,0,6
261,4539e2e3-90e9-419b-acd1-1597fbe4f42d,36744925,6452,240,24,216,1,6
261,4539e2e3-90e9-419b-acd1-1597fbe4f42d,36744925,6452,994,242,752,2,6
261,4539e2e3-90e9-419b-acd1-1597fbe4f42d,36744925,6452,1521,1030,491,3,6
261,4539e2e3-90e9-419b-acd1-1597fbe4f42d,36744925,6452,2304,1545,759,4,6
261,4539e2e3-90e9-419b-acd1-1597fbe4f42d,36744925,6452,3780,2308,1472,5,6
261,4539e2e3-90e9-419b-acd1-1597fbe4f42d,36744925,6452,4396,3840,556,6,6
259,172369d8-618e-4041-b974-232fcd2965db,36770136,1732,43,8,35,0,6
259,172369d8-618e-4041-b974-232fcd2965db,36770136,1732,80,45,35,1,6
259,172369d8-618e-4041-b974-232fcd2965db,36770136,1732,95,82,13,5,6
259,172369d8-618e-4041-b974-232fcd2965db,36770136,1732,622,96,526,6,6
261,567e9e71-dd2d-4321-87e2-84f0e8d19b69,36763902,8604,684,20,664,0,49
261,567e9e71-dd2d-4321-87e2-84f0e8d19b69,36763902,8604,701,686,15,1,49
261,567e9e71-dd2d-4321-87e2-84f0e8d19b69,36763902,8604,1350,710,640,4,49
261,567e9e71-dd2d-4321-87e2-84f0e8d19b69,36763902,8604,1351,1351,0,5,49
261,567e9e71-dd2d-4321-87e2-84f0e8d19b69,36763902,8604,1739,1371,368,8,49
261,567e9e71-dd2d-4321-87e2-84f0e8d19b69,36763902,8604,1862,1760,102,9,49
261,567e9e71-dd2d-4321-87e2-84f0e8d19b69,36763902,8604,2225,1898,327,16,49
261,567e9e71-dd2d-4321-87e2-84f0e8d19b69,36763902,8604,2503,2232,271,21,49
261,567e9e71-dd2d-4321-87e2-84f0e8d19b69,36763902,8604,2651,2496,155,22,49
261,567e9e71-dd2d-4321-87e2-84f0e8d19b69,36763902,8604,2650,2641,-9,23,49
261,567e9e71-dd2d-4321-87e2-84f0e8d19b69,36763902,8604,3123,2645,478,40,49
261,567e9e71-dd2d-4321-87e2-84f0e8d19b69,36763902,8604,3554,3153,401,47,49
261,567e9e71-dd2d-4321-87e2-84f0e8d19b69,36763902,8604,4050,3575,475,48,49
261,567e9e71-dd2d-4321-87e2-84f0e8d19b69,36763902,8604,4907,4101,806,49,49
250,b8ffc2af-977e-41ed-b09c-88d32bad01b1,36771749,8826,363,59,304,0,70
250,b8ffc2af-977e-41ed-b09c-88d32bad01b1,36771749,8826,476,397,79,1,70
250,b8ffc2af-977e-41ed-b09c-88d32bad01b1,36771749,8826,523,479,44,8,70
250,b8ffc2af-977e-41ed-b09c-88d32bad01b1,36771749,8826,702,541,161,9,70
250,b8ffc2af-977e-41ed-b09c-88d32bad01b1,36771749,8826,1030,706,324,12,70
250,b8ffc2af-977e-41ed-b09c-88d32bad01b1,36771749,8826,1336,1041,295,20,70
250,b8ffc2af-977e-41ed-b09c-88d32bad01b1,36771749,8826,1432,1363,69,21,70
250,b8ffc2af-977e-41ed-b09c-88d32bad01b1,36771749,8826,1721,1439,282,25,70
250,b8ffc2af-977e-41ed-b09c-88d32bad01b1,36771749,8826,2042,1735,307,30,70
250,b8ffc2af-977e-41ed-b09c-88d32bad01b1,36771749,8826,2057,2047,-10,31,70
250,b8ffc2af-977e-41ed-b09c-88d32bad01b1,36771749,8826,2567,2151,416,39,70
250,b8ffc2af-977e-41ed-b09c-88d32bad01b1,36771749,8826,2980,2628,352,41,70
250,b8ffc2af-977e-41ed-b09c-88d32bad01b1,36771749,8826,3292,3013,279,42,70
250,b8ffc2af-977e-41ed-b09c-88d32bad01b1,36771749,8826,3789,3316,473,49,70
250,b8ffc2af-977e-41ed-b09c-88d32bad01b1,36771749,8826,4012,3792,220,56,70
250,b8ffc2af-977e-41ed-b09c-88d32bad01b1,36771749,8826,4133,4035,98,57,70
250,b8ffc2af-977e-41ed-b09c-88d32bad01b1,36771749,8826,4601,4150,451,63,70
250,b8ffc2af-977e-41ed-b09c-88d32bad01b1,36771749,8826,4993,4606,387,64,70
250,b8ffc2af-977e-41ed-b09c-88d32bad01b1,36771749,8826,5373,5051,322,65,70
250,b8ffc2af-977e-41ed-b09c-88d32bad01b1,36771749,8826,6820,5393,1427,66,70
250,b8ffc2af-977e-41ed-b09c-88d32bad01b1,36771749,8826,7161,6826,335,67,70
250,b8ffc2af-977e-41ed-b09c-88d32bad01b1,36771749,8826,7139,6755,-384,68,70
250,b8ffc2af-977e-41ed-b09c-88d32bad01b1,36771749,8826,6731,6436,-295,69,70
250,b8ffc2af-977e-41ed-b09c-88d32bad01b1,36771749,8826,7161,6483,678,70,70
261,d94f1c8f-5ea6-4b04-8b52-253dcc0ae65c,36777494,6220,377,25,352,0,18
261,d94f1c8f-5ea6-4b04-8b52-253dcc0ae65c,36777494,6220,396,396,0,2,18
261,d94f1c8f-5ea6-4b04-8b52-253dcc0ae65c,36777494,6220,1036,995,41,3,18
261,d94f1c8f-5ea6-4b04-8b52-253dcc0ae65c,36777494,6220,1825,1039,786,12,18
261,d94f1c8f-5ea6-4b04-8b52-253dcc0ae65c,36777494,6220,2185,1829,356,13,18
261,d94f1c8f-5ea6-4b04-8b52-253dcc0ae65c,36777494,6220,3475,2233,1242,14,18
261,d94f1c8f-5ea6-4b04-8b52-253dcc0ae65c,36777494,6220,3830,3481,349,15,18
261,d94f1c8f-5ea6-4b04-8b52-253dcc0ae65c,36777494,6220,4164,3876,288,16,18
261,d94f1c8f-5ea6-4b04-8b52-253dcc0ae65c,36777494,6220,4145,3387,-758,17,18
261,d94f1c8f-5ea6-4b04-8b52-253dcc0ae65c,36777494,6220,3369,3273,-96,18,18
261,d94f1c8f-5ea6-4b04-8b52-253dcc0ae65c,36776167,9036,1788,31,1757,0,15
261,d94f1c8f-5ea6-4b04-8b52-253dcc0ae65c,36776167,9036,2636,1870,766,1,15
261,d94f1c8f-5ea6-4b04-8b52-253dcc0ae65c,36776167,9036,4011,2641,1370,3,15
261,d94f1c8f-5ea6-4b04-8b52-253dcc0ae65c,36776167,9036,5004,4039,965,4,15
261,d94f1c8f-5ea6-4b04-8b52-253dcc0ae65c,36776167,9036,6488,5033,1455,5,15
261,d94f1c8f-5ea6-4b04-8b52-253dcc0ae65c,36776167,9036,6980,1195,-5785,6,15
261,d94f1c8f-5ea6-4b04-8b52-253dcc0ae65c,36776167,9036,988,0,-988,7,15
261,d94f1c8f-5ea6-4b04-8b52-253dcc0ae65c,36776167,9036,258,192,66,8,15
261,d94f1c8f-5ea6-4b04-8b52-253dcc0ae65c,36776167,9036,256,256,0,10,15
261,d94f1c8f-5ea6-4b04-8b52-253dcc0ae65c,36776167,9036,264,247,17,11,15
261,d94f1c8f-5ea6-4b04-8b52-253dcc0ae65c,36776167,9036,283,254,-29,12,15
261,d94f1c8f-5ea6-4b04-8b52-253dcc0ae65c,36776167,9036,319,256,63,13,15
261,d94f1c8f-5ea6-4b04-8b52-253dcc0ae65c,36776167,9036,323,239,-84,14,15
261,d94f1c8f-5ea6-4b04-8b52-253dcc0ae65c,36776167,9036,235,107,-128,15,15
250,ee44ab94-02eb-4911-b09d-e54ba737f8b0,36780610,4239,285,21,264,0,46
250,ee44ab94-02eb-4911-b09d-e54ba737f8b0,36780610,4239,354,287,67,1,46
250,ee44ab94-02eb-4911-b09d-e54ba737f8b0,36780610,4239,693,361,332,2,46
250,ee44ab94-02eb-4911-b09d-e54ba737f8b0,36780610,4239,826,701,125,3,46
250,ee44ab94-02eb-4911-b09d-e54ba737f8b0,36780610,4239,889,829,60,4,46
250,ee44ab94-02eb-4911-b09d-e54ba737f8b0,36780610,4239,1084,903,181,5,46
250,ee44ab94-02eb-4911-b09d-e54ba737f8b0,36780610,4239,1530,1088,442,9,46
250,ee44ab94-02eb-4911-b09d-e54ba737f8b0,36780610,4239,1532,1532,0,10,46
250,ee44ab94-02eb-4911-b09d-e54ba737f8b0,36780610,4239,1713,1533,180,11,46
250,ee44ab94-02eb-4911-b09d-e54ba737f8b0,36780610,4239,1723,1718,5,12,46
250,ee44ab94-02eb-4911-b09d-e54ba737f8b0,36780610,4239,2099,1729,370,13,46
250,ee44ab94-02eb-4911-b09d-e54ba737f8b0,36780610,4239,2103,2103,0,15,46
250,ee44ab94-02eb-4911-b09d-e54ba737f8b0,36780610,4239,2430,2124,306,16,46
250,ee44ab94-02eb-4911-b09d-e54ba737f8b0,36780610,4239,2438,2438,0,24,46
250,ee44ab94-02eb-4911-b09d-e54ba737f8b0,36780610,4239,2574,2467,107,25,46
250,ee44ab94-02eb-4911-b09d-e54ba737f8b0,36780610,4239,2574,2573,1,46,46
250,ee44ab94-02eb-4911-b09d-e54ba737f8b0,36779901,3321,585,2,583,0,22
250,ee44ab94-02eb-4911-b09d-e54ba737f8b0,36779901,3321,869,607,262,13,22
250,ee44ab94-02eb-4911-b09d-e54ba737f8b0,36779901,3321,1080,870,210,14,22
250,ee44ab94-02eb-4911-b09d-e54ba737f8b0,36779901,3321,1380,1090,290,15,22
250,ee44ab94-02eb-4911-b09d-e54ba737f8b0,36779901,3321,1500,1384,116,17,22
250,ee44ab94-02eb-4911-b09d-e54ba737f8b0,36779901,3321,1582,1501,81,21,22
250,ee44ab94-02eb-4911-b09d-e54ba737f8b0,36779901,3321,1656,1589,67,22,22
250,ee44ab94-02eb-4911-b09d-e54ba737f8b0,36756107,5280,731,56,675,0,18
250,ee44ab94-02eb-4911-b09d-e54ba737f8b0,36756107,5280,1115,733,382,4,18
250,ee44ab94-02eb-4911-b09d-e54ba737f8b0,36756107,5280,1487,1137,350,12,18
250,ee44ab94-02eb-4911-b09d-e54ba737f8b0,36756107,5280,2122,1492,630,13,18
250,ee44ab94-02eb-4911-b09d-e54ba737f8b0,36756107,5280,2692,2124,568,14,18
250,ee44ab94-02eb-4911-b09d-e54ba737f8b0,36756107,5280,2718,2698,20,15,18
250,ee44ab94-02eb-4911-b09d-e54ba737f8b0,36756107,5280,3041,2720,321,17,18
250,ee44ab94-02eb-4911-b09d-e54ba737f8b0,36756107,5280,3615,3071,544,18,18
250,ee44ab94-02eb-4911-b09d-e54ba737f8b0,36763902,6453,523,11,512,0,94
250,ee44ab94-02eb-4911-b09d-e54ba737f8b0,36763902,6453,785,544,241,1,94
250,ee44ab94-02eb-4911-b09d-e54ba737f8b0,36763902,6453,1144,792,352,29,94
250,ee44ab94-02eb-4911-b09d-e54ba737f8b0,36763902,6453,1170,1150,20,30,94
250,ee44ab94-02eb-4911-b09d-e54ba737f8b0,36763902,6453,1932,1227,705,39,94
250,ee44ab94-02eb-4911-b09d-e54ba737f8b0,36763902,6453,1947,1933,14,40,94
250,ee44ab94-02eb-4911-b09d-e54ba737f8b0,36763902,6453,1925,1772,-153,41,94
250,ee44ab94-02eb-4911-b09d-e54ba737f8b0,36763902,6453,1771,1771,0,42,94
250,ee44ab94-02eb-4911-b09d-e54ba737f8b0,36763902,6453,1884,1773,111,43,94
250,ee44ab94-02eb-4911-b09d-e54ba737f8b0,36763902,6453,1882,1873,-9,44,94
250,ee44ab94-02eb-4911-b09d-e54ba737f8b0,36763902,6453,2397,1892,505,47,94
250,ee44ab94-02eb-4911-b09d-e54ba737f8b0,36763902,6453,2408,2402,6,51,94
250,ee44ab94-02eb-4911-b09d-e54ba737f8b0,36763902,6453,2812,2419,393,52,94
250,ee44ab94-02eb-4911-b09d-e54ba737f8b0,36763902,6453,3162,2825,337,63,94
250,ee44ab94-02eb-4911-b09d-e54ba737f8b0,36763902,6453,3469,3167,302,64,94
250,ee44ab94-02eb-4911-b09d-e54ba737f8b0,36763902,6453,4571,3476,1095,79,94
250,ee44ab94-02eb-4911-b09d-e54ba737f8b0,36763902,6453,4695,4575,120,92,94
250,ee44ab94-02eb-4911-b09d-e54ba737f8b0,36763902,6453,4781,4701,80,93,94
250,ee44ab94-02eb-4911-b09d-e54ba737f8b0,36763902,6453,4788,4782,6,94,94
261,f8cccb74-12d4-49c8-9e7c-7f24092ce84d,36775437,7884,162,4,158,0,6
261,f8cccb74-12d4-49c8-9e7c-7f24092ce84d,36775437,7884,412,166,246,1,6
261,f8cccb74-12d4-49c8-9e7c-7f24092ce84d,36775437,7884,1161,421,740,2,6
261,f8cccb74-12d4-49c8-9e7c-7f24092ce84d,36775437,7884,1609,1194,415,3,6
261,f8cccb74-12d4-49c8-9e7c-7f24092ce84d,36775437,7884,3777,1700,2077,4,6
261,f8cccb74-12d4-49c8-9e7c-7f24092ce84d,36775437,7884,5389,3781,1608,5,6
261,f8cccb74-12d4-49c8-9e7c-7f24092ce84d,36775437,7884,5828,5453,375,6,6
261,f8cccb74-12d4-49c8-9e7c-7f24092ce84d,36780610,5652,561,62,499,0,9
261,f8cccb74-12d4-49c8-9e7c-7f24092ce84d,36780610,5652,1100,582,518,1,9
261,f8cccb74-12d4-49c8-9e7c-7f24092ce84d,36780610,5652,1520,1101,419,2,9
261,f8cccb74-12d4-49c8-9e7c-7f24092ce84d,36780610,5652,1572,1522,50,3,9
261,f8cccb74-12d4-49c8-9e7c-7f24092ce84d,36780610,5652,1657,1587,70,4,9
261,f8cccb74-12d4-49c8-9e7c-7f24092ce84d,36780610,5652,1606,1476,-130,5,9
261,f8cccb74-12d4-49c8-9e7c-7f24092ce84d,36780610,5652,1512,1487,25,6,9
261,f8cccb74-12d4-49c8-9e7c-7f24092ce84d,36780610,5652,2050,1514,536,7,9
261,f8cccb74-12d4-49c8-9e7c-7f24092ce84d,36780610,5652,3596,1653,-1943,8,9
261,f8cccb74-12d4-49c8-9e7c-7f24092ce84d,36780610,5652,1510,0,-1510,9,9
261,f8cccb74-12d4-49c8-9e7c-7f24092ce84d,36776114,3432,404,24,380,0,4
261,f8cccb74-12d4-49c8-9e7c-7f24092ce84d,36776114,3432,442,405,37,1,4
261,f8cccb74-12d4-49c8-9e7c-7f24092ce84d,36776114,3432,726,449,277,2,4
261,f8cccb74-12d4-49c8-9e7c-7f24092ce84d,36776114,3432,1259,743,516,3,4
261,f8cccb74-12d4-49c8-9e7c-7f24092ce84d,36776114,3432,1376,1263,113,4,4
261,eff94206-4432-4709-bf66-e627d5380fa5,36772253,4772,222,7,215,0,77
261,eff94206-4432-4709-bf66-e627d5380fa5,36772253,4772,512,227,285,1,77
261,eff94206-4432-4709-bf66-e627d5380fa5,36772253,4772,829,522,307,12,77
261,eff94206-4432-4709-bf66-e627d5380fa5,36772253,4772,1241,831,410,13,77
261,eff94206-4432-4709-bf66-e627d5380fa5,36772253,4772,1303,1250,53,26,77
261,eff94206-4432-4709-bf66-e627d5380fa5,36772253,4772,1570,1311,259,27,77
261,eff94206-4432-4709-bf66-e627d5380fa5,36772253,4772,1988,1617,371,53,77
261,eff94206-4432-4709-bf66-e627d5380fa5,36772253,4772,2297,2002,295,54,77
261,eff94206-4432-4709-bf66-e627d5380fa5,36772253,4772,2367,2308,59,55,77
261,eff94206-4432-4709-bf66-e627d5380fa5,36772253,4772,2716,2386,330,56,77
261,eff94206-4432-4709-bf66-e627d5380fa5,36772253,4772,2666,807,-1859,74,77
261,eff94206-4432-4709-bf66-e627d5380fa5,36772253,4772,650,0,-650,75,77
261,eff94206-4432-4709-bf66-e627d5380fa5,36772253,4772,273,13,260,76,77
261,eff94206-4432-4709-bf66-e627d5380fa5,36772253,4772,167,0,-167,77,77
250,5d068e98-43c8-4ff9-8026-9221f89e4a26,36778350,10044,521,13,508,0,9
250,5d068e98-43c8-4ff9-8026-9221f89e4a26,36778350,10044,1954,528,1426,2,9
250,5d068e98-43c8-4ff9-8026-9221f89e4a26,36778350,10044,2527,347,-2180,3,9
250,5d068e98-43c8-4ff9-8026-9221f89e4a26,36778350,10044,892,349,543,8,9
250,5d068e98-43c8-4ff9-8026-9221f89e4a26,36778350,10044,1063,911,152,9,9
250,5d068e98-43c8-4ff9-8026-9221f89e4a26,36781770,5088,494,26,468,0,24
250,5d068e98-43c8-4ff9-8026-9221f89e4a26,36781770,5088,507,498,9,1,24
250,5d068e98-43c8-4ff9-8026-9221f89e4a26,36781770,5088,922,528,394,4,24
250,5d068e98-43c8-4ff9-8026-9221f89e4a26,36781770,5088,1094,931,163,9,24
250,5d068e98-43c8-4ff9-8026-9221f89e4a26,36781770,5088,1407,1100,307,10,24
250,5d068e98-43c8-4ff9-8026-9221f89e4a26,36781770,5088,1628,1410,218,14,24
250,5d068e98-43c8-4ff9-8026-9221f89e4a26,36781770,5088,1975,1703,272,15,24
250,5d068e98-43c8-4ff9-8026-9221f89e4a26,36781770,5088,2011,1982,29,18,24
250,5d068e98-43c8-4ff9-8026-9221f89e4a26,36781770,5088,2435,2027,408,19,24
250,5d068e98-43c8-4ff9-8026-9221f89e4a26,36781770,5088,2912,2442,470,21,24
250,5d068e98-43c8-4ff9-8026-9221f89e4a26,36781770,5088,3117,2913,204,22,24
250,5d068e98-43c8-4ff9-8026-9221f89e4a26,36781770,5088,3170,3120,50,23,24
250,5d068e98-43c8-4ff9-8026-9221f89e4a26,36781770,5088,3423,3178,245,24,24
250,5d068e98-43c8-4ff9-8026-9221f89e4a26,36780715,12582,524,13,511,0,12
250,5d068e98-43c8-4ff9-8026-9221f89e4a26,36780715,12582,982,527,455,1,12
250,5d068e98-43c8-4ff9-8026-9221f89e4a26,36780715,12582,1425,1042,383,2,12
250,5d068e98-43c8-4ff9-8026-9221f89e4a26,36780715,12582,1882,1464,418,5,12
250,5d068e98-43c8-4ff9-8026-9221f89e4a26,36780715,12582,1891,1884,7,6,12
250,5d068e98-43c8-4ff9-8026-9221f89e4a26,36780715,12582,8315,1911,6404,11,12
250,5d068e98-43c8-4ff9-8026-9221f89e4a26,36780715,12582,10917,8603,2314,12,12
250,25e0ef2f-e5e6-4370-b7dd-5e2f4d38114a,36789972,6531,364,25,339,0,128
250,25e0ef2f-e5e6-4370-b7dd-5e2f4d38114a,36789972,6531,806,381,425,1,128
250,25e0ef2f-e5e6-4370-b7dd-5e2f4d38114a,36789972,6531,1363,833,530,2,128
250,25e0ef2f-e5e6-4370-b7dd-5e2f4d38114a,36789972,6531,1434,1375,59,3,128
250,25e0ef2f-e5e6-4370-b7dd-5e2f4d38114a,36789972,6531,2000,1451,549,5,128
250,25e0ef2f-e5e6-4370-b7dd-5e2f4d38114a,36789972,6531,2239,2003,236,9,128
250,25e0ef2f-e5e6-4370-b7dd-5e2f4d38114a,36789972,6531,2443,2266,177,10,128
250,25e0ef2f-e5e6-4370-b7dd-5e2f4d38114a,36789972,6531,2486,2458,28,17,128
250,25e0ef2f-e5e6-4370-b7dd-5e2f4d38114a,36789972,6531,2696,2517,179,18,128
250,25e0ef2f-e5e6-4370-b7dd-5e2f4d38114a,36789972,6531,3095,2704,391,24,128
250,25e0ef2f-e5e6-4370-b7dd-5e2f4d38114a,36789972,6531,3610,3112,498,81,128
250,25e0ef2f-e5e6-4370-b7dd-5e2f4d38114a,36789972,6531,3559,3024,-535,84,128
250,25e0ef2f-e5e6-4370-b7dd-5e2f4d38114a,36789972,6531,2950,2424,-526,85,128
250,25e0ef2f-e5e6-4370-b7dd-5e2f4d38114a,36789972,6531,2418,2057,-361,86,128
250,25e0ef2f-e5e6-4370-b7dd-5e2f4d38114a,36789972,6531,2043,1885,-158,87,128
250,25e0ef2f-e5e6-4370-b7dd-5e2f4d38114a,36789972,6531,2322,1846,476,88,128
250,25e0ef2f-e5e6-4370-b7dd-5e2f4d38114a,36789972,6531,2757,2327,430,89,128
250,25e0ef2f-e5e6-4370-b7dd-5e2f4d38114a,36789972,6531,3295,2763,532,90,128
250,25e0ef2f-e5e6-4370-b7dd-5e2f4d38114a,36789972,6531,3303,3299,4,91,128
250,25e0ef2f-e5e6-4370-b7dd-5e2f4d38114a,36789972,6531,3937,3325,612,99,128
250,25e0ef2f-e5e6-4370-b7dd-5e2f4d38114a,36789972,6531,4014,3941,73,115,128
250,25e0ef2f-e5e6-4370-b7dd-5e2f4d38114a,36789972,6531,4026,4016,10,116,128
250,25e0ef2f-e5e6-4370-b7dd-5e2f4d38114a,36789972,6531,4656,4083,573,127,128
250,25e0ef2f-e5e6-4370-b7dd-5e2f4d38114a,36789972,6531,4866,4663,203,128,128
250,25e0ef2f-e5e6-4370-b7dd-5e2f4d38114a,36786481,5124,138,3,135,0,12
250,25e0ef2f-e5e6-4370-b7dd-5e2f4d38114a,36786481,5712,192,143,49,1,12
250,25e0ef2f-e5e6-4370-b7dd-5e2f4d38114a,36786481,5712,1038,217,821,2,12
250,25e0ef2f-e5e6-4370-b7dd-5e2f4d38114a,36786481,5712,1120,1051,69,3,12
250,25e0ef2f-e5e6-4370-b7dd-5e2f4d38114a,36786481,5712,1433,1145,288,12,12
261,2e5fd721-9cf8-4512-a918-ee43dcd01a9f,36790956,9748,356,39,317,0,12
261,2e5fd721-9cf8-4512-a918-ee43dcd01a9f,36790956,9748,781,393,388,1,12
261,2e5fd721-9cf8-4512-a918-ee43dcd01a9f,36790956,9748,1139,794,345,2,12
261,2e5fd721-9cf8-4512-a918-ee43dcd01a9f,36790956,9748,1484,1183,301,3,12
261,2e5fd721-9cf8-4512-a918-ee43dcd01a9f,36790956,9748,1682,1490,192,5,12
261,2e5fd721-9cf8-4512-a918-ee43dcd01a9f,36790956,9748,2107,1686,421,6,12
261,2e5fd721-9cf8-4512-a918-ee43dcd01a9f,36790956,9748,4183,2202,1981,7,12
261,2e5fd721-9cf8-4512-a918-ee43dcd01a9f,36790956,9748,4227,3263,-964,8,12
261,2e5fd721-9cf8-4512-a918-ee43dcd01a9f,36790956,9748,3250,2475,-775,12,12
261,2e5fd721-9cf8-4512-a918-ee43dcd01a9f,36774751,9876,188,26,162,0,3
261,2e5fd721-9cf8-4512-a918-ee43dcd01a9f,36774751,9876,216,190,26,1,3
261,2e5fd721-9cf8-4512-a918-ee43dcd01a9f,36774751,9876,220,217,3,2,3
261,2e5fd721-9cf8-4512-a918-ee43dcd01a9f,36774751,9876,222,221,1,3,3
261,2e5fd721-9cf8-4512-a918-ee43dcd01a9f,36772303,7036,197,28,169,0,23
261,2e5fd721-9cf8-4512-a918-ee43dcd01a9f,36772303,7036,201,198,3,1,23
261,2e5fd721-9cf8-4512-a918-ee43dcd01a9f,36772303,7036,319,203,116,2,23
261,2e5fd721-9cf8-4512-a918-ee43dcd01a9f,36772303,7036,358,321,37,3,23
261,2e5fd721-9cf8-4512-a918-ee43dcd01a9f,36772303,7036,457,360,97,4,23
261,2e5fd721-9cf8-4512-a918-ee43dcd01a9f,36772303,7036,618,477,141,5,23
261,2e5fd721-9cf8-4512-a918-ee43dcd01a9f,36772303,7036,687,619,68,6,23
261,2e5fd721-9cf8-4512-a918-ee43dcd01a9f,36772303,7036,911,691,220,7,23
261,2e5fd721-9cf8-4512-a918-ee43dcd01a9f,36772303,7036,957,912,45,8,23
261,2e5fd721-9cf8-4512-a918-ee43dcd01a9f,36772303,7036,967,958,9,9,23
261,2e5fd721-9cf8-4512-a918-ee43dcd01a9f,36772303,7036,1579,992,587,11,23
261,2e5fd721-9cf8-4512-a918-ee43dcd01a9f,36772303,7036,1712,1598,114,12,23
261,2e5fd721-9cf8-4512-a918-ee43dcd01a9f,36772303,7036,2321,1729,592,13,23
261,2e5fd721-9cf8-4512-a918-ee43dcd01a9f,36772303,7036,2418,0,-2418,14,23
261,2e5fd721-9cf8-4512-a918-ee43dcd01a9f,36772303,7036,2791,82,2709,15,23
261,2e5fd721-9cf8-4512-a918-ee43dcd01a9f,36772303,7036,2858,2792,66,16,23
261,2e5fd721-9cf8-4512-a918-ee43dcd01a9f,36772303,7036,3128,2860,268,19,23
261,2e5fd721-9cf8-4512-a918-ee43dcd01a9f,36772303,7036,3783,3144,639,20,23
261,2e5fd721-9cf8-4512-a918-ee43dcd01a9f,36772303,7036,4199,3822,377,21,23
261,2e5fd721-9cf8-4512-a918-ee43dcd01a9f,36772303,7036,4760,4222,538,22,23
261,2e5fd721-9cf8-4512-a918-ee43dcd01a9f,36772303,7036,4980,4779,201,23,23
261,2e5fd721-9cf8-4512-a918-ee43dcd01a9f,36785883,6616,971,1,970,0,2
261,2e5fd721-9cf8-4512-a918-ee43dcd01a9f,36785883,6616,4419,980,3439,1,2
261,2e5fd721-9cf8-4512-a918-ee43dcd01a9f,36785883,6616,4560,0,-4560,2,2
261,2e5fd721-9cf8-4512-a918-ee43dcd01a9f,36767373,6296,70,14,56,0,108
261,2e5fd721-9cf8-4512-a918-ee43dcd01a9f,36767373,6296,149,72,77,1,108
261,2e5fd721-9cf8-4512-a918-ee43dcd01a9f,36767373,6296,307,173,134,4,108
261,2e5fd721-9cf8-4512-a918-ee43dcd01a9f,36767373,6296,458,322,136,5,108
261,2e5fd721-9cf8-4512-a918-ee43dcd01a9f,36767373,6296,667,488,179,7,108
261,2e5fd721-9cf8-4512-a918-ee43dcd01a9f,36767373,6296,739,683,56,8,108
261,2e5fd721-9cf8-4512-a918-ee43dcd01a9f,36767373,6296,907,741,166,9,108
261,2e5fd721-9cf8-4512-a918-ee43dcd01a9f,36767373,6296,1014,917,97,10,108
261,2e5fd721-9cf8-4512-a918-ee43dcd01a9f,36767373,6296,1149,1024,125,11,108
261,2e5fd721-9cf8-4512-a918-ee43dcd01a9f,36767373,6296,1542,1150,392,23,108
261,2e5fd721-9cf8-4512-a918-ee43dcd01a9f,36767373,6296,1826,1560,266,24,108
261,2e5fd721-9cf8-4512-a918-ee43dcd01a9f,36767373,6296,2043,1830,213,32,108
261,2e5fd721-9cf8-4512-a918-ee43dcd01a9f,36767373,6296,2105,2056,49,35,108
261,2e5fd721-9cf8-4512-a918-ee43dcd01a9f,36767373,6296,2246,2117,129,36,108
261,2e5fd721-9cf8-4512-a918-ee43dcd01a9f,36767373,6296,2272,2272,0,60,108
261,2e5fd721-9cf8-4512-a918-ee43dcd01a9f,36767373,6296,2451,2289,162,61,108
261,2e5fd721-9cf8-4512-a918-ee43dcd01a9f,36767373,6296,3002,2477,525,70,108
261,2e5fd721-9cf8-4512-a918-ee43dcd01a9f,36767373,6296,3039,3009,30,71,108
261,2e5fd721-9cf8-4512-a918-ee43dcd01a9f,36767373,6296,3126,3055,71,72,108
261,2e5fd721-9cf8-4512-a918-ee43dcd01a9f,36767373,6296,3210,3144,66,73,108
261,2e5fd721-9cf8-4512-a918-ee43dcd01a9f,36767373,6296,3372,3227,145,77,108
261,2e5fd721-9cf8-4512-a918-ee43dcd01a9f,36767373,6296,3573,3390,183,82,108
261,2e5fd721-9cf8-4512-a918-ee43dcd01a9f,36767373,6296,3716,3580,136,88,108
261,2e5fd721-9cf8-4512-a918-ee43dcd01a9f,36767373,6296,3942,3742,200,89,108
261,2e5fd721-9cf8-4512-a918-ee43dcd01a9f,36767373,6296,4089,3971,118,91,108
261,2e5fd721-9cf8-4512-a918-ee43dcd01a9f,36767373,6296,4120,4096,24,92,108
261,2e5fd721-9cf8-4512-a918-ee43dcd01a9f,36767373,6296,4240,4129,111,96,108
261,2e5fd721-9cf8-4512-a918-ee43dcd01a9f,36767373,6296,4240,3786,454,106,108
261,2e5fd721-9cf8-4512-a918-ee43dcd01a9f,36767373,6296,4234,1589,-2645,107,108
261,2e5fd721-9cf8-4512-a918-ee43dcd01a9f,36767373,6296,1419,0,-1419,108,108
259,a13d8dca-062c-41af-9193-69e1dc1d7ae3,36794888,1830,267,1,266,0,7
259,a13d8dca-062c-41af-9193-69e1dc1d7ae3,36794888,1830,287,272,15,1,7
259,a13d8dca-062c-41af-9193-69e1dc1d7ae3,36794888,1830,720,308,412,6,7
259,a13d8dca-062c-41af-9193-69e1dc1d7ae3,36794888,1830,720,720,0,7,7
259,a13d8dca-062c-41af-9193-69e1dc1d7ae3,36794430,2186,263,26,237,0,54
259,a13d8dca-062c-41af-9193-69e1dc1d7ae3,36794430,2186,270,265,5,1,54
259,a13d8dca-062c-41af-9193-69e1dc1d7ae3,36794430,2186,271,271,0,6,54
259,a13d8dca-062c-41af-9193-69e1dc1d7ae3,36794430,2186,332,279,53,7,54
259,a13d8dca-062c-41af-9193-69e1dc1d7ae3,36794430,2186,321,304,-17,8,54
259,a13d8dca-062c-41af-9193-69e1dc1d7ae3,36794430,2186,303,239,-64,9,54
259,a13d8dca-062c-41af-9193-69e1dc1d7ae3,36794430,2186,547,291,256,10,54
259,a13d8dca-062c-41af-9193-69e1dc1d7ae3,36794430,2186,933,593,340,48,54
259,a13d8dca-062c-41af-9193-69e1dc1d7ae3,36794430,2186,1029,940,89,49,54
259,a13d8dca-062c-41af-9193-69e1dc1d7ae3,36794430,2186,1044,1029,15,50,54
259,a13d8dca-062c-41af-9193-69e1dc1d7ae3,36794430,2186,1076,1047,29,51,54
259,a13d8dca-062c-41af-9193-69e1dc1d7ae3,36794430,2186,1076,1065,-11,52,54
259,a13d8dca-062c-41af-9193-69e1dc1d7ae3,36794430,2186,1076,1068,8,53,54
259,a13d8dca-062c-41af-9193-69e1dc1d7ae3,36794430,2186,1076,1034,-42,54,54
259,a13d8dca-062c-41af-9193-69e1dc1d7ae3,36794430,2186,1076,1034,42,54,54
261,dfbf9df2-393c-4eb9-9842-5fe178d0187f,36800730,5648,460,34,426,0,19
261,dfbf9df2-393c-4eb9-9842-5fe178d0187f,36800730,5648,1091,467,624,1,19
261,dfbf9df2-393c-4eb9-9842-5fe178d0187f,36800730,5648,1637,1092,545,2,19
261,dfbf9df2-393c-4eb9-9842-5fe178d0187f,36800730,5648,1643,1640,3,3,19
261,dfbf9df2-393c-4eb9-9842-5fe178d0187f,36800730,5648,2128,1648,480,5,19
261,dfbf9df2-393c-4eb9-9842-5fe178d0187f,36800730,5648,2388,2147,241,6,19
261,dfbf9df2-393c-4eb9-9842-5fe178d0187f,36800730,5648,2760,2412,348,7,19
261,dfbf9df2-393c-4eb9-9842-5fe178d0187f,36800730,5648,3392,2784,608,17,19
261,dfbf9df2-393c-4eb9-9842-5fe178d0187f,36800730,5648,3592,3454,138,18,19
261,dfbf9df2-393c-4eb9-9842-5fe178d0187f,36800730,5648,3590,3361,-229,19,19
251,3653c212-215b-441f-96b4-c49b0f5d0302,36802646,4276,19,5,14,0,28
251,3653c212-215b-441f-96b4-c49b0f5d0302,36802646,4276,255,40,215,1,28
251,3653c212-215b-441f-96b4-c49b0f5d0302,36802646,4276,404,266,138,3,28
251,3653c212-215b-441f-96b4-c49b0f5d0302,36802646,4276,473,410,63,4,28
251,3653c212-215b-441f-96b4-c49b0f5d0302,36802646,4276,600,482,118,6,28
251,3653c212-215b-441f-96b4-c49b0f5d0302,36802646,4276,1216,604,612,7,28
251,3653c212-215b-441f-96b4-c49b0f5d0302,36802646,4276,1302,1229,73,8,28
251,3653c212-215b-441f-96b4-c49b0f5d0302,36802646,4276,2052,1327,725,12,28
251,3653c212-215b-441f-96b4-c49b0f5d0302,36802646,4276,1892,0,-1892,28,28
262,0a5c90d0-e6fc-49f6-a470-669f25b957f5,36804363,6404,599,1,598,0,5
262,0a5c90d0-e6fc-49f6-a470-669f25b957f5,36804363,6404,921,0,-921,1,5
262,0a5c90d0-e6fc-49f6-a470-669f25b957f5,36804363,6404,49,7,42,2,5
262,0a5c90d0-e6fc-49f6-a470-669f25b957f5,36804363,6404,4180,145,4035,3,5
262,0a5c90d0-e6fc-49f6-a470-669f25b957f5,36804363,6404,4135,886,-3249,4,5
262,0a5c90d0-e6fc-49f6-a470-669f25b957f5,36804363,6404,639,0,-639,5,5
262,0a5c90d0-e6fc-49f6-a470-669f25b957f5,36804245,7184,3923,110,3813,0,2
262,0a5c90d0-e6fc-49f6-a470-669f25b957f5,36804245,7184,4960,4083,877,1,2
262,0a5c90d0-e6fc-49f6-a470-669f25b957f5,36804245,7184,4757,0,-4757,2,2
262,0a5c90d0-e6fc-49f6-a470-669f25b957f5,36801346,52180,1200,31,1169,0,1
262,0a5c90d0-e6fc-49f6-a470-669f25b957f5,36801346,52180,1201,0,-1201,1,1
262,0a5c90d0-e6fc-49f6-a470-669f25b957f5,36805657,6416,354,76,278,0,1
262,0a5c90d0-e6fc-49f6-a470-669f25b957f5,36805657,6416,1335,451,884,1,1
126,ebbd7953-1298-4b1f-b3cb-cf5ece5d7816,36809083,2922,150,4,146,0,32
126,ebbd7953-1298-4b1f-b3cb-cf5ece5d7816,36809083,2922,416,155,261,1,32
126,ebbd7953-1298-4b1f-b3cb-cf5ece5d7816,36809083,2922,419,417,2,2,32
126,ebbd7953-1298-4b1f-b3cb-cf5ece5d7816,36809083,2922,555,420,135,5,32
126,ebbd7953-1298-4b1f-b3cb-cf5ece5d7816,36809083,2922,822,557,265,6,32
126,ebbd7953-1298-4b1f-b3cb-cf5ece5d7816,36809083,2922,925,823,102,7,32
126,ebbd7953-1298-4b1f-b3cb-cf5ece5d7816,36809083,2922,945,926,19,8,32
126,ebbd7953-1298-4b1f-b3cb-cf5ece5d7816,36809083,2922,1103,956,147,15,32
126,ebbd7953-1298-4b1f-b3cb-cf5ece5d7816,36809083,2922,1316,1109,207,16,32
126,ebbd7953-1298-4b1f-b3cb-cf5ece5d7816,36809083,2922,1545,1326,219,18,32
126,ebbd7953-1298-4b1f-b3cb-cf5ece5d7816,36809083,2922,1695,1549,146,19,32
126,ebbd7953-1298-4b1f-b3cb-cf5ece5d7816,36809083,2922,1772,1699,73,20,32
126,ebbd7953-1298-4b1f-b3cb-cf5ece5d7816,36809083,2922,1812,1775,37,21,32
126,ebbd7953-1298-4b1f-b3cb-cf5ece5d7816,36809083,2922,1811,1807,-4,27,32
126,ebbd7953-1298-4b1f-b3cb-cf5ece5d7816,36809083,2922,1812,1805,7,30,32
126,ebbd7953-1298-4b1f-b3cb-cf5ece5d7816,36809083,2922,1811,1666,-145,31,32
126,ebbd7953-1298-4b1f-b3cb-cf5ece5d7816,36809083,2922,1665,0,-1665,32,32
261,bc5f815c-a15a-46f8-92f1-650ca069a3fe,36809570,11660,572,6,566,0,18
261,bc5f815c-a15a-46f8-92f1-650ca069a3fe,36809570,11660,682,580,102,1,18
261,bc5f815c-a15a-46f8-92f1-650ca069a3fe,36809570,11660,696,696,0,4,18
261,bc5f815c-a15a-46f8-92f1-650ca069a3fe,36809570,11660,997,730,267,5,18
261,bc5f815c-a15a-46f8-92f1-650ca069a3fe,36809570,11660,1204,1009,195,10,18
261,bc5f815c-a15a-46f8-92f1-650ca069a3fe,36809570,11660,1717,1214,503,11,18
261,bc5f815c-a15a-46f8-92f1-650ca069a3fe,36809570,11660,2398,1746,652,12,18
261,bc5f815c-a15a-46f8-92f1-650ca069a3fe,36809570,11660,3353,2463,890,13,18
261,bc5f815c-a15a-46f8-92f1-650ca069a3fe,36809570,11660,5646,3357,2289,14,18
261,bc5f815c-a15a-46f8-92f1-650ca069a3fe,36809570,11660,7592,5648,1944,15,18
261,bc5f815c-a15a-46f8-92f1-650ca069a3fe,36809570,11660,9595,7599,1996,16,18
261,bc5f815c-a15a-46f8-92f1-650ca069a3fe,36809570,11660,9604,6384,-3220,17,18
261,bc5f815c-a15a-46f8-92f1-650ca069a3fe,36809570,11660,6310,0,-6310,18,18
261,858ff2d9-4b66-44ec-8b27-614bc832d176,36819182,3780,229,6,223,0,60
261,858ff2d9-4b66-44ec-8b27-614bc832d176,36819182,3780,889,251,638,7,60
261,858ff2d9-4b66-44ec-8b27-614bc832d176,36819182,3780,1124,913,211,8,60
261,858ff2d9-4b66-44ec-8b27-614bc832d176,36819182,3780,1546,1136,410,14,60
261,858ff2d9-4b66-44ec-8b27-614bc832d176,36819182,3780,1724,1563,161,15,60
261,858ff2d9-4b66-44ec-8b27-614bc832d176,36819182,2056,0,0,0,19,60
261,858ff2d9-4b66-44ec-8b27-614bc832d176,36819182,27952,565,7,558,21,60
261,858ff2d9-4b66-44ec-8b27-614bc832d176,36819182,27952,568,567,1,22,60
261,858ff2d9-4b66-44ec-8b27-614bc832d176,36819182,30616,902,575,327,23,60
261,858ff2d9-4b66-44ec-8b27-614bc832d176,36819182,30616,1069,930,139,24,60
261,858ff2d9-4b66-44ec-8b27-614bc832d176,36819182,30616,1223,1071,152,31,60
261,858ff2d9-4b66-44ec-8b27-614bc832d176,36819182,30616,1434,1255,179,32,60
261,858ff2d9-4b66-44ec-8b27-614bc832d176,36819182,30616,1611,1445,166,39,60
261,858ff2d9-4b66-44ec-8b27-614bc832d176,36819182,30616,1774,1645,129,40,60
261,858ff2d9-4b66-44ec-8b27-614bc832d176,36819182,30612,2198,1785,413,42,60
261,858ff2d9-4b66-44ec-8b27-614bc832d176,36819182,30612,2208,2202,6,43,60
261,858ff2d9-4b66-44ec-8b27-614bc832d176,36819182,30612,2427,2227,200,48,60
261,858ff2d9-4b66-44ec-8b27-614bc832d176,36819182,30612,2561,2429,132,49,60
261,858ff2d9-4b66-44ec-8b27-614bc832d176,36819182,30612,3290,2629,661,57,60
261,858ff2d9-4b66-44ec-8b27-614bc832d176,36819182,30612,3358,3306,52,58,60
261,858ff2d9-4b66-44ec-8b27-614bc832d176,36819182,30612,3322,2956,-366,59,60
261,858ff2d9-4b66-44ec-8b27-614bc832d176,36819182,30612,2930,2377,-553,60,60
261,858ff2d9-4b66-44ec-8b27-614bc832d176,36818384,5236,379,25,354,0,49
261,858ff2d9-4b66-44ec-8b27-614bc832d176,36818384,5236,495,392,103,1,49
261,858ff2d9-4b66-44ec-8b27-614bc832d176,36818384,5236,756,508,248,8,49
261,858ff2d9-4b66-44ec-8b27-614bc832d176,36818384,5236,780,759,21,11,49
261,858ff2d9-4b66-44ec-8b27-614bc832d176,36818384,5236,1092,821,271,12,49
261,858ff2d9-4b66-44ec-8b27-614bc832d176,36818384,5236,1196,1093,103,13,49
261,858ff2d9-4b66-44ec-8b27-614bc832d176,36818384,5236,1231,1196,35,14,49
261,858ff2d9-4b66-44ec-8b27-614bc832d176,36818384,5236,1252,1232,20,15,49
261,858ff2d9-4b66-44ec-8b27-614bc832d176,36818384,5236,1292,1253,39,16,49
261,858ff2d9-4b66-44ec-8b27-614bc832d176,36818384,5236,1547,1294,253,17,49
261,858ff2d9-4b66-44ec-8b27-614bc832d176,36818384,5236,1788,1557,231,28,49
261,858ff2d9-4b66-44ec-8b27-614bc832d176,36818384,5236,2081,1814,267,32,49
261,858ff2d9-4b66-44ec-8b27-614bc832d176,36818384,5236,2331,2094,237,36,49
261,858ff2d9-4b66-44ec-8b27-614bc832d176,36818384,5236,2962,2341,621,42,49
261,858ff2d9-4b66-44ec-8b27-614bc832d176,36818384,5236,2954,2499,-455,48,49
261,858ff2d9-4b66-44ec-8b27-614bc832d176,36818384,5236,2498,2496,-2,49,49
261,858ff2d9-4b66-44ec-8b27-614bc832d176,36818055,9188,429,36,393,0,15
261,858ff2d9-4b66-44ec-8b27-614bc832d176,36818055,9188,770,442,328,1,15
261,858ff2d9-4b66-44ec-8b27-614bc832d176,36818055,9188,962,774,188,6,15
261,858ff2d9-4b66-44ec-8b27-614bc832d176,36818055,9188,947,109,-838,14,15
261,858ff2d9-4b66-44ec-8b27-614bc832d176,36818055,9188,102,96,-6,15,15
261,858ff2d9-4b66-44ec-8b27-614bc832d176,36793052,6320,188,1,187,0,60
261,858ff2d9-4b66-44ec-8b27-614bc832d176,36793052,6320,814,195,619,1,60
261,858ff2d9-4b66-44ec-8b27-614bc832d176,36793052,6320,978,829,149,17,60
261,858ff2d9-4b66-44ec-8b27-614bc832d176,36793052,6320,1417,979,438,18,60
261,858ff2d9-4b66-44ec-8b27-614bc832d176,36793052,6320,1639,1463,176,22,60
261,858ff2d9-4b66-44ec-8b27-614bc832d176,36793052,6320,2358,1652,706,23,60
261,858ff2d9-4b66-44ec-8b27-614bc832d176,36793052,6320,2733,2420,313,33,60
261,858ff2d9-4b66-44ec-8b27-614bc832d176,36793052,6320,2985,2745,240,39,60
261,858ff2d9-4b66-44ec-8b27-614bc832d176,36793052,6320,2986,2986,0,40,60
261,858ff2d9-4b66-44ec-8b27-614bc832d176,36793052,6320,3072,2998,74,43,60
261,858ff2d9-4b66-44ec-8b27-614bc832d176,36793052,6320,3099,3073,26,44,60
261,858ff2d9-4b66-44ec-8b27-614bc832d176,36793052,6320,3101,3101,0,45,60
261,858ff2d9-4b66-44ec-8b27-614bc832d176,36793052,6320,3165,3102,63,46,60
261,858ff2d9-4b66-44ec-8b27-614bc832d176,36793052,6320,3301,3168,133,47,60
261,858ff2d9-4b66-44ec-8b27-614bc832d176,36793052,6320,3568,3324,244,48,60
261,858ff2d9-4b66-44ec-8b27-614bc832d176,36793052,6320,3740,3569,171,51,60
261,858ff2d9-4b66-44ec-8b27-614bc832d176,36793052,6320,3842,3756,86,52,60
261,858ff2d9-4b66-44ec-8b27-614bc832d176,36793052,6320,4155,3865,290,59,60
261,858ff2d9-4b66-44ec-8b27-614bc832d176,36793052,6320,4264,4163,101,60,60
261,858ff2d9-4b66-44ec-8b27-614bc832d176,36805051,6700,1104,14,1090,0,2
261,858ff2d9-4b66-44ec-8b27-614bc832d176,36805051,6700,3035,1169,1866,1,2
261,858ff2d9-4b66-44ec-8b27-614bc832d176,36805051,6700,4644,3043,1601,2,2
261,858ff2d9-4b66-44ec-8b27-614bc832d176,36794105,12856,902,47,855,0,45
261,858ff2d9-4b66-44ec-8b27-614bc832d176,36794105,12856,1140,929,211,1,45
261,858ff2d9-4b66-44ec-8b27-614bc832d176,36794105,12856,2015,1163,852,11,45
261,858ff2d9-4b66-44ec-8b27-614bc832d176,36794105,12856,2418,2045,373,19,45
261,858ff2d9-4b66-44ec-8b27-614bc832d176,36794105,12856,2425,2421,4,20,45
261,858ff2d9-4b66-44ec-8b27-614bc832d176,36794105,12856,2566,2433,133,24,45
261,858ff2d9-4b66-44ec-8b27-614bc832d176,36794105,12856,2836,2567,269,25,45
261,858ff2d9-4b66-44ec-8b27-614bc832d176,36794105,12856,2995,2858,137,27,45
261,858ff2d9-4b66-44ec-8b27-614bc832d176,36794105,12856,3931,3036,895,28,45
261,858ff2d9-4b66-44ec-8b27-614bc832d176,36794105,12856,4346,3937,409,29,45
261,858ff2d9-4b66-44ec-8b27-614bc832d176,36794105,12856,4342,4170,-172,43,45
261,858ff2d9-4b66-44ec-8b27-614bc832d176,36794105,12856,4168,3809,-359,44,45
261,858ff2d9-4b66-44ec-8b27-614bc832d176,36794105,12856,3774,0,-3774,45,45
259,9d82de59-0e76-4eba-9783-f3ad0e782827,36829391,2764,72,1,71,0,22
259,9d82de59-0e76-4eba-9783-f3ad0e782827,36829391,2764,680,73,607,1,22
259,9d82de59-0e76-4eba-9783-f3ad0e782827,36829391,2764,717,692,25,8,22
259,9d82de59-0e76-4eba-9783-f3ad0e782827,36829391,2764,760,727,33,9,22
259,9d82de59-0e76-4eba-9783-f3ad0e782827,36829391,2764,854,769,85,10,22
259,9d82de59-0e76-4eba-9783-f3ad0e782827,36829391,2764,990,860,130,18,22
259,9d82de59-0e76-4eba-9783-f3ad0e782827,36829391,2764,1122,995,127,19,22
259,9d82de59-0e76-4eba-9783-f3ad0e782827,36829391,2764,1329,1121,208,20,22
259,9d82de59-0e76-4eba-9783-f3ad0e782827,36829391,2764,1642,1336,306,21,22
259,9d82de59-0e76-4eba-9783-f3ad0e782827,36829391,2764,1654,1654,0,22,22
259,9d82de59-0e76-4eba-9783-f3ad0e782827,36829574,3422,423,16,407,0,1
259,9d82de59-0e76-4eba-9783-f3ad0e782827,36829574,3422,558,441,117,1,1
259,8ec49700-acff-46b1-b935-ff7f36af8c7b,36827725,1284,132,7,125,0,1
259,8ec49700-acff-46b1-b935-ff7f36af8c7b,36827725,1284,131,131,0,1,1
261,4d774b4c-2b62-4796-bb94-ad14a9bb2595,36824902,7528,493,6,487,0,53
261,4d774b4c-2b62-4796-bb94-ad14a9bb2595,36824902,7528,658,468,190,1,53
261,4d774b4c-2b62-4796-bb94-ad14a9bb2595,36824902,7528,513,38,-475,2,53
261,4d774b4c-2b62-4796-bb94-ad14a9bb2595,36824902,7528,36,35,-1,3,53
261,4d774b4c-2b62-4796-bb94-ad14a9bb2595,36824902,7528,532,65,467,4,53
261,4d774b4c-2b62-4796-bb94-ad14a9bb2595,36824902,7528,573,539,34,8,53
261,4d774b4c-2b62-4796-bb94-ad14a9bb2595,36824902,7528,777,585,192,9,53
261,4d774b4c-2b62-4796-bb94-ad14a9bb2595,36824902,7528,1050,796,254,10,53
261,4d774b4c-2b62-4796-bb94-ad14a9bb2595,36824902,7528,1093,1061,32,11,53
261,4d774b4c-2b62-4796-bb94-ad14a9bb2595,36824902,7528,2154,1111,1043,13,53
261,4d774b4c-2b62-4796-bb94-ad14a9bb2595,36824902,7528,2977,2157,820,14,53
261,4d774b4c-2b62-4796-bb94-ad14a9bb2595,36824902,7528,3003,2983,20,15,53
261,4d774b4c-2b62-4796-bb94-ad14a9bb2595,36824902,7528,3319,3015,304,21,53
261,4d774b4c-2b62-4796-bb94-ad14a9bb2595,36824902,7528,3601,3338,263,23,53
261,4d774b4c-2b62-4796-bb94-ad14a9bb2595,36824902,7528,3836,3557,279,24,53
261,4d774b4c-2b62-4796-bb94-ad14a9bb2595,36824902,7528,4550,3851,699,31,53
261,4d774b4c-2b62-4796-bb94-ad14a9bb2595,36824902,7528,5024,4568,456,37,53
261,4d774b4c-2b62-4796-bb94-ad14a9bb2595,36824902,7528,5083,5036,47,38,53
261,4d774b4c-2b62-4796-bb94-ad14a9bb2595,36824902,7528,5067,4723,-344,42,53
261,4d774b4c-2b62-4796-bb94-ad14a9bb2595,36824902,7528,4708,4328,-380,44,53
261,4d774b4c-2b62-4796-bb94-ad14a9bb2595,36824902,7528,4945,4348,597,48,53
261,4d774b4c-2b62-4796-bb94-ad14a9bb2595,36824902,7528,5366,4960,406,50,53
261,4d774b4c-2b62-4796-bb94-ad14a9bb2595,36824902,7528,5472,5390,82,52,53
261,4d774b4c-2b62-4796-bb94-ad14a9bb2595,36824902,7528,5431,4675,-756,53,53
261,fe5ffb8d-f70e-4da6-a9f8-40c97c15ce9d,36783521,14480,794,29,765,0,24
261,fe5ffb8d-f70e-4da6-a9f8-40c97c15ce9d,36783521,14480,1367,816,551,1,24
261,fe5ffb8d-f70e-4da6-a9f8-40c97c15ce9d,36783521,14480,2103,1370,733,2,24
261,fe5ffb8d-f70e-4da6-a9f8-40c97c15ce9d,36783521,14480,4182,2148,2034,3,24
261,fe5ffb8d-f70e-4da6-a9f8-40c97c15ce9d,36783521,14480,4461,4194,267,11,24
261,fe5ffb8d-f70e-4da6-a9f8-40c97c15ce9d,36783521,14480,4970,4490,480,16,24
261,fe5ffb8d-f70e-4da6-a9f8-40c97c15ce9d,36783521,14480,5892,4980,912,17,24
261,fe5ffb8d-f70e-4da6-a9f8-40c97c15ce9d,36783521,14480,7909,5935,1974,18,24
261,fe5ffb8d-f70e-4da6-a9f8-40c97c15ce9d,36783521,14480,10147,7918,2229,19,24
261,fe5ffb8d-f70e-4da6-a9f8-40c97c15ce9d,36783521,14480,10148,9912,-236,20,24
261,fe5ffb8d-f70e-4da6-a9f8-40c97c15ce9d,36783521,14480,10767,10048,719,21,24
261,fe5ffb8d-f70e-4da6-a9f8-40c97c15ce9d,36783521,14480,10675,9840,-835,22,24
261,fe5ffb8d-f70e-4da6-a9f8-40c97c15ce9d,36783521,14480,9835,7801,-2034,23,24
261,fe5ffb8d-f70e-4da6-a9f8-40c97c15ce9d,36783521,14480,7779,7585,-194,24,24
259,22c4fbf7-2a2b-4d26-a8a4-6e7b3306b23f,36838347,7114,24,1,23,0,47
259,22c4fbf7-2a2b-4d26-a8a4-6e7b3306b23f,36838347,7114,106,25,81,1,47
259,22c4fbf7-2a2b-4d26-a8a4-6e7b3306b23f,36838347,7114,185,107,78,2,47
259,22c4fbf7-2a2b-4d26-a8a4-6e7b3306b23f,36838347,7114,572,188,384,3,47
259,22c4fbf7-2a2b-4d26-a8a4-6e7b3306b23f,36838347,7114,644,573,71,6,47
259,22c4fbf7-2a2b-4d26-a8a4-6e7b3306b23f,36838347,7114,648,645,3,7,47
259,22c4fbf7-2a2b-4d26-a8a4-6e7b3306b23f,36838347,7114,684,649,35,8,47
259,22c4fbf7-2a2b-4d26-a8a4-6e7b3306b23f,36838347,7114,800,688,112,9,47
259,22c4fbf7-2a2b-4d26-a8a4-6e7b3306b23f,36838347,7114,973,802,171,10,47
259,22c4fbf7-2a2b-4d26-a8a4-6e7b3306b23f,36838347,7114,974,974,0,14,47
259,22c4fbf7-2a2b-4d26-a8a4-6e7b3306b23f,36838347,7114,1092,980,112,15,47
259,22c4fbf7-2a2b-4d26-a8a4-6e7b3306b23f,36838347,7114,1331,1095,236,16,47
259,22c4fbf7-2a2b-4d26-a8a4-6e7b3306b23f,36838347,7114,1336,1333,3,17,47
259,22c4fbf7-2a2b-4d26-a8a4-6e7b3306b23f,36838347,7114,1568,1347,221,20,47
259,22c4fbf7-2a2b-4d26-a8a4-6e7b3306b23f,36838347,7114,1690,1575,115,21,47
259,22c4fbf7-2a2b-4d26-a8a4-6e7b3306b23f,36838347,7114,1783,1692,91,23,47
259,22c4fbf7-2a2b-4d26-a8a4-6e7b3306b23f,36838347,7114,1840,1785,55,26,47
259,22c4fbf7-2a2b-4d26-a8a4-6e7b3306b23f,36838347,7114,1931,1843,88,27,47
259,22c4fbf7-2a2b-4d26-a8a4-6e7b3306b23f,36838347,7114,2418,1947,471,28,47
259,22c4fbf7-2a2b-4d26-a8a4-6e7b3306b23f,36838347,7114,2437,2422,15,29,47
259,22c4fbf7-2a2b-4d26-a8a4-6e7b3306b23f,36838347,7114,2520,2441,79,40,47
259,22c4fbf7-2a2b-4d26-a8a4-6e7b3306b23f,36838347,7114,2578,2524,54,41,47
259,22c4fbf7-2a2b-4d26-a8a4-6e7b3306b23f,36838347,7114,2885,2581,304,43,47
259,22c4fbf7-2a2b-4d26-a8a4-6e7b3306b23f,36838347,7114,3470,2886,584,44,47
259,22c4fbf7-2a2b-4d26-a8a4-6e7b3306b23f,36838347,7114,3517,3478,39,46,47
259,22c4fbf7-2a2b-4d26-a8a4-6e7b3306b23f,36838347,7114,3879,3527,352,47,47
261,507e54ef-c191-46cb-b513-8642e15d21e5,36844425,3184,173,18,155,0,11
261,507e54ef-c191-46cb-b513-8642e15d21e5,36844425,3184,359,196,163,1,11
261,507e54ef-c191-46cb-b513-8642e15d21e5,36844425,3184,551,364,187,2,11
261,507e54ef-c191-46cb-b513-8642e15d21e5,36844425,3184,833,596,237,3,11
261,507e54ef-c191-46cb-b513-8642e15d21e5,36844425,3184,1128,853,275,5,11
261,507e54ef-c191-46cb-b513-8642e15d21e5,36844425,3184,1124,1113,-11,8,11
261,507e54ef-c191-46cb-b513-8642e15d21e5,36844425,3184,1120,1116,4,9,11
261,507e54ef-c191-46cb-b513-8642e15d21e5,36844425,3184,1128,0,-1128,10,11
261,507e54ef-c191-46cb-b513-8642e15d21e5,36844425,20884,45,1,44,11,11
261,507e54ef-c191-46cb-b513-8642e15d21e5,36843386,9044,420,32,388,0,9
261,507e54ef-c191-46cb-b513-8642e15d21e5,36843386,9044,810,456,354,1,9
261,507e54ef-c191-46cb-b513-8642e15d21e5,36843386,9044,1413,814,599,2,9
261,507e54ef-c191-46cb-b513-8642e15d21e5,36843386,9044,2244,1472,772,3,9
261,507e54ef-c191-46cb-b513-8642e15d21e5,36843386,9044,5247,2292,2955,5,9
261,507e54ef-c191-46cb-b513-8642e15d21e5,36843386,9044,4802,3294,-1508,6,9
261,507e54ef-c191-46cb-b513-8642e15d21e5,36843386,9044,6661,4314,2347,7,9
261,507e54ef-c191-46cb-b513-8642e15d21e5,36843386,9044,6786,3886,-2900,8,9
261,507e54ef-c191-46cb-b513-8642e15d21e5,36843386,9044,6988,3769,3219,9,9
261,507e54ef-c191-46cb-b513-8642e15d21e5,36843071,4148,1412,32,1380,0,0
261,507e54ef-c191-46cb-b513-8642e15d21e5,36834757,9760,445,38,407,0,4
261,507e54ef-c191-46cb-b513-8642e15d21e5,36834757,9760,705,450,255,1,4
261,507e54ef-c191-46cb-b513-8642e15d21e5,36834757,9760,1436,753,683,2,4
261,507e54ef-c191-46cb-b513-8642e15d21e5,36834757,9760,2268,1467,801,3,4
261,507e54ef-c191-46cb-b513-8642e15d21e5,36834757,9760,2270,2269,1,4,4
261,736d16cc-25ce-4c90-9d89-4e9c452c2d9a,36848411,5252,80,5,75,0,6
261,736d16cc-25ce-4c90-9d89-4e9c452c2d9a,36848411,5252,628,100,528,1,6
261,736d16cc-25ce-4c90-9d89-4e9c452c2d9a,36848411,5252,1098,637,461,2,6
261,736d16cc-25ce-4c90-9d89-4e9c452c2d9a,36848411,5252,1290,1110,180,4,6
261,736d16cc-25ce-4c90-9d89-4e9c452c2d9a,36848411,5252,2534,1298,1236,5,6
261,736d16cc-25ce-4c90-9d89-4e9c452c2d9a,36848411,5252,3196,2553,643,6,6
261,736d16cc-25ce-4c90-9d89-4e9c452c2d9a,36843375,11412,527,41,486,0,9
261,736d16cc-25ce-4c90-9d89-4e9c452c2d9a,36843375,11412,630,537,93,1,9
261,736d16cc-25ce-4c90-9d89-4e9c452c2d9a,36843375,11412,1821,634,1187,2,9
261,736d16cc-25ce-4c90-9d89-4e9c452c2d9a,36843375,11412,1905,1836,69,3,9
261,736d16cc-25ce-4c90-9d89-4e9c452c2d9a,36843375,11412,4331,1949,2382,4,9
261,736d16cc-25ce-4c90-9d89-4e9c452c2d9a,36843375,11412,5529,3804,1725,5,9
261,736d16cc-25ce-4c90-9d89-4e9c452c2d9a,36843375,11412,6130,5581,549,6,9
261,736d16cc-25ce-4c90-9d89-4e9c452c2d9a,36843375,11412,6456,6165,291,7,9
261,736d16cc-25ce-4c90-9d89-4e9c452c2d9a,36843375,11412,7982,6458,1524,8,9
261,736d16cc-25ce-4c90-9d89-4e9c452c2d9a,36843375,11412,8144,7994,150,9,9
261,2a24ffc7-deaf-4e4d-99fb-4f675d36d829,36871390,6328,174,3,171,0,27
261,2a24ffc7-deaf-4e4d-99fb-4f675d36d829,36871390,6328,299,196,103,1,27
261,2a24ffc7-deaf-4e4d-99fb-4f675d36d829,36871390,6328,665,311,354,9,27
261,2a24ffc7-deaf-4e4d-99fb-4f675d36d829,36871390,6328,845,682,163,13,27
261,2a24ffc7-deaf-4e4d-99fb-4f675d36d829,36871390,6328,861,847,14,14,27
261,2a24ffc7-deaf-4e4d-99fb-4f675d36d829,36871390,6328,916,863,53,15,27
261,2a24ffc7-deaf-4e4d-99fb-4f675d36d829,36871390,6328,998,917,81,16,27
261,2a24ffc7-deaf-4e4d-99fb-4f675d36d829,36871390,6328,1816,1019,797,20,27
261,2a24ffc7-deaf-4e4d-99fb-4f675d36d829,36871390,6328,2336,1855,481,25,27
261,2a24ffc7-deaf-4e4d-99fb-4f675d36d829,36871390,6328,2830,2371,459,26,27
261,2a24ffc7-deaf-4e4d-99fb-4f675d36d829,36871390,6328,2891,2842,49,27,27
261,411efe87-b340-42cf-812b-a489dd9f8b8f,36865435,6756,130,12,118,0,33
261,411efe87-b340-42cf-812b-a489dd9f8b8f,36865435,6756,163,131,32,1,33
261,411efe87-b340-42cf-812b-a489dd9f8b8f,36865435,6756,180,164,16,2,33
261,411efe87-b340-42cf-812b-a489dd9f8b8f,36865435,6756,455,181,274,3,33
261,411efe87-b340-42cf-812b-a489dd9f8b8f,36865435,6756,1042,460,582,5,33
261,411efe87-b340-42cf-812b-a489dd9f8b8f,36865435,6756,1966,1069,897,8,33
261,411efe87-b340-42cf-812b-a489dd9f8b8f,36865435,6756,2638,1979,659,12,33
261,411efe87-b340-42cf-812b-a489dd9f8b8f,36865435,6756,2880,2667,213,13,33
261,411efe87-b340-42cf-812b-a489dd9f8b8f,36865435,6756,3737,2897,840,30,33
261,411efe87-b340-42cf-812b-a489dd9f8b8f,36865435,6756,4520,3762,758,31,33
261,411efe87-b340-42cf-812b-a489dd9f8b8f,36865435,6756,4700,4556,144,33,33
261,411efe87-b340-42cf-812b-a489dd9f8b8f,36847382,8764,2612,18,2594,0,10
261,411efe87-b340-42cf-812b-a489dd9f8b8f,36847382,8764,6015,2613,3402,1,10
261,411efe87-b340-42cf-812b-a489dd9f8b8f,36847382,8764,6708,6031,677,2,10
261,411efe87-b340-42cf-812b-a489dd9f8b8f,36847382,8764,6104,0,-6104,3,10
261,411efe87-b340-42cf-812b-a489dd9f8b8f,36847382,8764,468,34,434,6,10
261,411efe87-b340-42cf-812b-a489dd9f8b8f,36847382,8764,1138,524,614,7,10
261,411efe87-b340-42cf-812b-a489dd9f8b8f,36847382,8764,1357,1154,203,9,10
261,411efe87-b340-42cf-812b-a489dd9f8b8f,36847382,8764,1534,1379,155,10,10
261,5b4e39bc-d46d-484f-858f-74f0e6756fae,36881494,6380,742,7,735,0,13
261,5b4e39bc-d46d-484f-858f-74f0e6756fae,36881494,6380,1197,770,427,1,13
261,5b4e39bc-d46d-484f-858f-74f0e6756fae,36881494,6380,1347,1206,141,2,13
261,5b4e39bc-d46d-484f-858f-74f0e6756fae,36881494,6380,1283,259,-1024,10,13
261,5b4e39bc-d46d-484f-858f-74f0e6756fae,36881494,6380,192,36,-156,11,13
261,5b4e39bc-d46d-484f-858f-74f0e6756fae,36881494,6380,4324,59,4265,12,13
261,5b4e39bc-d46d-484f-858f-74f0e6756fae,36881494,6380,4321,4311,-10,13,13
261,5b4e39bc-d46d-484f-858f-74f0e6756fae,36880779,5736,109,5,104,0,45
261,5b4e39bc-d46d-484f-858f-74f0e6756fae,36880779,5736,438,113,325,1,45
261,5b4e39bc-d46d-484f-858f-74f0e6756fae,36880779,5736,742,453,289,2,45
261,5b4e39bc-d46d-484f-858f-74f0e6756fae,36880779,5736,958,755,203,3,45
261,5b4e39bc-d46d-484f-858f-74f0e6756fae,36880779,5736,1285,976,309,19,45
261,5b4e39bc-d46d-484f-858f-74f0e6756fae,36880779,5736,1968,1293,675,26,45
261,5b4e39bc-d46d-484f-858f-74f0e6756fae,36880779,5736,2284,1991,293,27,45
261,5b4e39bc-d46d-484f-858f-74f0e6756fae,36880779,5736,2489,2290,199,28,45
261,5b4e39bc-d46d-484f-858f-74f0e6756fae,36880779,5736,2480,2457,23,29,45
261,5b4e39bc-d46d-484f-858f-74f0e6756fae,36880779,5736,2733,2473,260,37,45
261,5b4e39bc-d46d-484f-858f-74f0e6756fae,36880779,5736,2933,2741,192,38,45
261,5b4e39bc-d46d-484f-858f-74f0e6756fae,36880779,5736,2949,2934,15,39,45
261,5b4e39bc-d46d-484f-858f-74f0e6756fae,36880779,5736,2990,2951,39,40,45
261,5b4e39bc-d46d-484f-858f-74f0e6756fae,36880779,5736,3006,2992,14,41,45
261,5b4e39bc-d46d-484f-858f-74f0e6756fae,36880779,5736,3105,3007,98,42,45
261,5b4e39bc-d46d-484f-858f-74f0e6756fae,36880779,5736,3466,3158,308,43,45
261,5b4e39bc-d46d-484f-858f-74f0e6756fae,36880779,5736,3680,828,-2852,44,45
261,5b4e39bc-d46d-484f-858f-74f0e6756fae,36880779,5736,757,0,-757,45,45
259,50411a5f-5ea9-44da-8328-fd37e9019de7,36881268,3660,562,7,555,0,24
259,50411a5f-5ea9-44da-8328-fd37e9019de7,36881268,3660,1408,565,843,3,24
259,50411a5f-5ea9-44da-8328-fd37e9019de7,36881268,3660,1409,1409,0,4,24
259,50411a5f-5ea9-44da-8328-fd37e9019de7,36881268,3660,1471,1417,54,7,24
259,50411a5f-5ea9-44da-8328-fd37e9019de7,36881268,3660,1535,1473,62,9,24
259,50411a5f-5ea9-44da-8328-fd37e9019de7,36881268,3660,1570,1539,31,10,24
259,50411a5f-5ea9-44da-8328-fd37e9019de7,36881268,3660,2120,1575,545,11,24
259,50411a5f-5ea9-44da-8328-fd37e9019de7,36881268,3660,2339,2121,218,21,24
259,50411a5f-5ea9-44da-8328-fd37e9019de7,36881268,3660,2350,2343,7,22,24
259,50411a5f-5ea9-44da-8328-fd37e9019de7,36881268,3660,2516,2366,150,23,24
259,50411a5f-5ea9-44da-8328-fd37e9019de7,36881268,3660,2550,2532,18,24,24
261,0e64319d-4891-4b50-9bba-6351c891587a,36890398,8876,223,31,192,0,9
261,0e64319d-4891-4b50-9bba-6351c891587a,36890398,8876,765,246,519,1,9
261,0e64319d-4891-4b50-9bba-6351c891587a,36890398,8876,1867,781,1086,2,9
261,0e64319d-4891-4b50-9bba-6351c891587a,36890398,8876,3078,1890,1188,3,9
261,0e64319d-4891-4b50-9bba-6351c891587a,36890398,8876,3565,3113,452,4,9
261,0e64319d-4891-4b50-9bba-6351c891587a,36890398,8876,4176,3577,599,5,9
261,0e64319d-4891-4b50-9bba-6351c891587a,36890398,8876,5497,4200,1297,6,9
261,0e64319d-4891-4b50-9bba-6351c891587a,36890398,8876,6820,5623,1197,7,9
261,0e64319d-4891-4b50-9bba-6351c891587a,36890398,8876,6812,6051,-761,9,9
261,0e64319d-4891-4b50-9bba-6351c891587a,36889828,6448,312,9,303,0,14
261,0e64319d-4891-4b50-9bba-6351c891587a,36889828,6448,659,330,329,1,14
261,0e64319d-4891-4b50-9bba-6351c891587a,36889828,6448,1033,674,359,4,14
261,0e64319d-4891-4b50-9bba-6351c891587a,36889828,6448,1107,1050,57,5,14
261,0e64319d-4891-4b50-9bba-6351c891587a,36889828,6448,1859,1126,733,6,14
261,0e64319d-4891-4b50-9bba-6351c891587a,36889828,6448,3020,1894,1126,13,14
261,0e64319d-4891-4b50-9bba-6351c891587a,36889828,6448,3791,3082,709,14,14
261,0e64319d-4891-4b50-9bba-6351c891587a,36855834,6676,370,26,344,0,5
261,0e64319d-4891-4b50-9bba-6351c891587a,36855834,6676,801,373,428,1,5
261,0e64319d-4891-4b50-9bba-6351c891587a,36855834,6676,1113,805,308,2,5
261,0e64319d-4891-4b50-9bba-6351c891587a,36855834,6676,1213,1129,84,3,5
261,0e64319d-4891-4b50-9bba-6351c891587a,36855834,6676,1206,858,-348,4,5
261,0e64319d-4891-4b50-9bba-6351c891587a,36855834,6676,856,854,-2,5,5
261,0e64319d-4891-4b50-9bba-6351c891587a,36847556,6512,424,43,381,0,20
261,0e64319d-4891-4b50-9bba-6351c891587a,36847556,6512,768,446,322,1,20
261,0e64319d-4891-4b50-9bba-6351c891587a,36847556,6512,1369,792,577,2,20
261,0e64319d-4891-4b50-9bba-6351c891587a,36847556,6512,1995,1384,611,5,20
261,0e64319d-4891-4b50-9bba-6351c891587a,36847556,6512,2027,1998,29,7,20
261,0e64319d-4891-4b50-9bba-6351c891587a,36847556,6512,2490,2057,433,8,20
261,0e64319d-4891-4b50-9bba-6351c891587a,36847556,6512,3333,2510,823,12,20
261,0e64319d-4891-4b50-9bba-6351c891587a,36847556,6512,3803,3359,444,13,20
261,0e64319d-4891-4b50-9bba-6351c891587a,36847556,6512,4314,3862,452,14,20
261,0e64319d-4891-4b50-9bba-6351c891587a,36847556,6512,4456,4348,108,20,20
261,0e64319d-4891-4b50-9bba-6351c891587a,36891428,16044,465,3,462,0,34
261,0e64319d-4891-4b50-9bba-6351c891587a,36891428,16044,577,489,88,1,34
261,0e64319d-4891-4b50-9bba-6351c891587a,36891428,16044,684,602,82,6,34
261,0e64319d-4891-4b50-9bba-6351c891587a,36891428,16044,1014,726,288,7,34
261,0e64319d-4891-4b50-9bba-6351c891587a,36891428,16044,1391,1050,341,12,34
261,0e64319d-4891-4b50-9bba-6351c891587a,36891428,16044,2128,1396,732,16,34
261,0e64319d-4891-4b50-9bba-6351c891587a,36891428,16044,2981,2152,829,17,34
261,0e64319d-4891-4b50-9bba-6351c891587a,36891428,16044,3712,2985,727,18,34
261,0e64319d-4891-4b50-9bba-6351c891587a,36891428,16044,5534,3753,1781,22,34
261,0e64319d-4891-4b50-9bba-6351c891587a,36891428,16044,5806,5567,239,23,34
261,0e64319d-4891-4b50-9bba-6351c891587a,36891428,16044,5885,5811,74,24,34
261,0e64319d-4891-4b50-9bba-6351c891587a,36891428,16044,5886,5886,0,25,34
261,0e64319d-4891-4b50-9bba-6351c891587a,36891428,16044,6316,5887,429,26,34
261,0e64319d-4891-4b50-9bba-6351c891587a,36891428,16044,6327,6320,7,27,34
261,0e64319d-4891-4b50-9bba-6351c891587a,36891428,16044,6913,6377,536,29,34
261,0e64319d-4891-4b50-9bba-6351c891587a,36891428,16044,7555,6926,629,30,34
261,0e64319d-4891-4b50-9bba-6351c891587a,36891428,16044,10398,7618,2780,31,34
261,0e64319d-4891-4b50-9bba-6351c891587a,36891428,16044,11399,10448,951,32,34
261,0e64319d-4891-4b50-9bba-6351c891587a,36891428,16044,11387,10872,-515,33,34
261,0e64319d-4891-4b50-9bba-6351c891587a,36891428,16044,10820,10508,-312,34,34
261,be6b0d55-191a-42d0-a879-eeecc544dc05,36911896,3908,185,9,176,0,32
261,be6b0d55-191a-42d0-a879-eeecc544dc05,36911896,3908,222,186,36,3,32
261,be6b0d55-191a-42d0-a879-eeecc544dc05,36911896,3908,224,223,1,4,32
261,be6b0d55-191a-42d0-a879-eeecc544dc05,36911896,3908,303,225,78,6,32
261,be6b0d55-191a-42d0-a879-eeecc544dc05,36911896,3908,551,307,244,7,32
261,be6b0d55-191a-42d0-a879-eeecc544dc05,36911896,3908,706,559,147,8,32
261,be6b0d55-191a-42d0-a879-eeecc544dc05,36911896,3908,836,716,120,9,32
261,be6b0d55-191a-42d0-a879-eeecc544dc05,36911896,3908,867,838,29,10,32
261,be6b0d55-191a-42d0-a879-eeecc544dc05,36911896,3908,909,869,40,11,32
261,be6b0d55-191a-42d0-a879-eeecc544dc05,36911896,3908,956,910,46,12,32
261,be6b0d55-191a-42d0-a879-eeecc544dc05,36911896,3908,972,957,15,13,32
261,be6b0d55-191a-42d0-a879-eeecc544dc05,36911896,3908,998,973,25,14,32
261,be6b0d55-191a-42d0-a879-eeecc544dc05,36911896,3908,1035,1000,35,20,32
261,be6b0d55-191a-42d0-a879-eeecc544dc05,36911896,3908,1163,1044,119,21,32
261,be6b0d55-191a-42d0-a879-eeecc544dc05,36911896,3908,1180,1165,15,22,32
261,be6b0d55-191a-42d0-a879-eeecc544dc05,36911896,3908,1181,1181,0,23,32
261,be6b0d55-191a-42d0-a879-eeecc544dc05,36911896,3908,1184,1182,2,27,32
261,be6b0d55-191a-42d0-a879-eeecc544dc05,36911896,3908,1183,1183,0,28,32
261,be6b0d55-191a-42d0-a879-eeecc544dc05,36911896,3908,1210,1184,26,30,32
261,be6b0d55-191a-42d0-a879-eeecc544dc05,36911896,3908,1215,1211,4,31,32
261,be6b0d55-191a-42d0-a879-eeecc544dc05,36911896,3908,1215,1215,0,32,32
261,be6b0d55-191a-42d0-a879-eeecc544dc05,36911766,3044,339,22,317,0,10
261,be6b0d55-191a-42d0-a879-eeecc544dc05,36911766,3044,624,367,257,1,10
261,be6b0d55-191a-42d0-a879-eeecc544dc05,36911766,3044,699,625,74,2,10
261,be6b0d55-191a-42d0-a879-eeecc544dc05,36911766,3044,711,700,11,3,10
261,be6b0d55-191a-42d0-a879-eeecc544dc05,36911766,3044,988,720,268,9,10
261,be6b0d55-191a-42d0-a879-eeecc544dc05,36911766,3044,988,987,1,10,10
261,be6b0d55-191a-42d0-a879-eeecc544dc05,36911766,3044,988,987,-1,10,10
261,be6b0d55-191a-42d0-a879-eeecc544dc05,36909827,8856,403,27,376,0,67
261,be6b0d55-191a-42d0-a879-eeecc544dc05,36909827,8856,870,428,442,13,67
261,be6b0d55-191a-42d0-a879-eeecc544dc05,36909827,8856,992,875,117,17,67
261,be6b0d55-191a-42d0-a879-eeecc544dc05,36909827,8856,1235,1018,217,18,67
261,be6b0d55-191a-42d0-a879-eeecc544dc05,36909827,8856,1918,1248,670,26,67
261,be6b0d55-191a-42d0-a879-eeecc544dc05,36909827,8856,2346,1931,415,27,67
261,be6b0d55-191a-42d0-a879-eeecc544dc05,36909827,8856,2348,2347,1,28,67
261,be6b0d55-191a-42d0-a879-eeecc544dc05,36909827,8856,2686,2365,321,37,67
261,be6b0d55-191a-42d0-a879-eeecc544dc05,36909827,8856,2955,2697,258,38,67
261,be6b0d55-191a-42d0-a879-eeecc544dc05,36909827,8856,3561,2986,575,44,67
261,be6b0d55-191a-42d0-a879-eeecc544dc05,36909827,8856,3859,3579,280,47,67
261,be6b0d55-191a-42d0-a879-eeecc544dc05,36909827,8856,4874,3863,1011,54,67
261,be6b0d55-191a-42d0-a879-eeecc544dc05,36909827,8856,5332,4920,412,55,67
261,be6b0d55-191a-42d0-a879-eeecc544dc05,36909827,8856,5576,5338,238,59,67
261,be6b0d55-191a-42d0-a879-eeecc544dc05,36909827,8856,5706,5595,111,60,67
261,be6b0d55-191a-42d0-a879-eeecc544dc05,36909827,8856,6475,5733,742,61,67
261,be6b0d55-191a-42d0-a879-eeecc544dc05,36909827,8856,6800,6507,293,62,67
261,be6b0d55-191a-42d0-a879-eeecc544dc05,36909827,8856,6743,6068,-675,66,67
261,be6b0d55-191a-42d0-a879-eeecc544dc05,36909827,8856,6058,6025,-33,67,67
261,be6b0d55-191a-42d0-a879-eeecc544dc05,36910766,8844,447,44,403,0,24
261,be6b0d55-191a-42d0-a879-eeecc544dc05,36910766,8844,481,456,25,1,24
261,be6b0d55-191a-42d0-a879-eeecc544dc05,36910766,8844,1277,509,768,5,24
261,be6b0d55-191a-42d0-a879-eeecc544dc05,36910766,8844,1301,1283,18,6,24
261,be6b0d55-191a-42d0-a879-eeecc544dc05,36910766,8844,1921,1337,584,12,24
261,be6b0d55-191a-42d0-a879-eeecc544dc05,36910766,8844,2504,1980,524,13,24
261,be6b0d55-191a-42d0-a879-eeecc544dc05,36910766,8844,3349,2559,790,22,24
261,be6b0d55-191a-42d0-a879-eeecc544dc05,36910766,8844,4870,3360,1510,23,24
261,be6b0d55-191a-42d0-a879-eeecc544dc05,36910766,8844,5990,4907,1083,24,24
261,be6b0d55-191a-42d0-a879-eeecc544dc05,36906818,4732,344,8,336,0,57
261,be6b0d55-191a-42d0-a879-eeecc544dc05,36906818,4732,549,366,183,8,57
261,be6b0d55-191a-42d0-a879-eeecc544dc05,36906818,4732,602,551,51,9,57
261,be6b0d55-191a-42d0-a879-eeecc544dc05,36906818,4732,680,603,77,10,57
261,be6b0d55-191a-42d0-a879-eeecc544dc05,36906818,4732,803,682,121,11,57
261,be6b0d55-191a-42d0-a879-eeecc544dc05,36906818,4732,904,805,99,12,57
261,be6b0d55-191a-42d0-a879-eeecc544dc05,36906818,4732,1003,916,87,13,57
261,be6b0d55-191a-42d0-a879-eeecc544dc05,36906818,4732,1132,1011,121,23,57
261,be6b0d55-191a-42d0-a879-eeecc544dc05,36906818,4732,1163,1134,29,24,57
261,be6b0d55-191a-42d0-a879-eeecc544dc05,36906818,4732,1667,1164,503,25,57
261,be6b0d55-191a-42d0-a879-eeecc544dc05,36906818,4732,1694,1674,20,26,57
261,be6b0d55-191a-42d0-a879-eeecc544dc05,36906818,4732,2277,1705,572,40,57
261,be6b0d55-191a-42d0-a879-eeecc544dc05,36906818,4732,2676,2289,387,41,57
261,be6b0d55-191a-42d0-a879-eeecc544dc05,36906818,4732,2668,2049,-619,56,57
261,be6b0d55-191a-42d0-a879-eeecc544dc05,36906818,4732,2009,1803,-206,57,57
261,be6b0d55-191a-42d0-a879-eeecc544dc05,36901907,5924,244,10,234,0,30
261,be6b0d55-191a-42d0-a879-eeecc544dc05,36901907,5924,431,251,180,1,30
261,be6b0d55-191a-42d0-a879-eeecc544dc05,36901907,5924,577,435,142,2,30
261,be6b0d55-191a-42d0-a879-eeecc544dc05,36901907,5924,588,584,4,3,30
261,be6b0d55-191a-42d0-a879-eeecc544dc05,36901907,5924,1095,612,483,4,30
261,be6b0d55-191a-42d0-a879-eeecc544dc05,36901907,5924,1140,1101,39,5,30
261,be6b0d55-191a-42d0-a879-eeecc544dc05,36901907,5924,1179,1141,38,6,30
261,be6b0d55-191a-42d0-a879-eeecc544dc05,36901907,5924,1414,1205,209,8,30
261,be6b0d55-191a-42d0-a879-eeecc544dc05,36901907,5924,1478,1418,60,9,30
261,be6b0d55-191a-42d0-a879-eeecc544dc05,36901907,5924,1873,1491,382,12,30
261,be6b0d55-191a-42d0-a879-eeecc544dc05,36901907,5924,1886,1874,12,13,30
261,be6b0d55-191a-42d0-a879-eeecc544dc05,36901907,5924,2386,1906,480,18,30
261,be6b0d55-191a-42d0-a879-eeecc544dc05,36901907,5924,2958,2394,564,19,30
261,be6b0d55-191a-42d0-a879-eeecc544dc05,36901907,5924,2960,2959,1,20,30
261,be6b0d55-191a-42d0-a879-eeecc544dc05,36901907,5924,3270,2977,293,21,30
261,be6b0d55-191a-42d0-a879-eeecc544dc05,36901907,5924,3518,3284,234,22,30
261,be6b0d55-191a-42d0-a879-eeecc544dc05,36901907,5924,3710,3524,186,25,30
261,be6b0d55-191a-42d0-a879-eeecc544dc05,36901907,5924,3752,3714,38,26,30
261,be6b0d55-191a-42d0-a879-eeecc544dc05,36901907,5924,3868,3753,115,30,30
261,be6b0d55-191a-42d0-a879-eeecc544dc05,36895395,5420,145,24,121,0,27
261,be6b0d55-191a-42d0-a879-eeecc544dc05,36895395,5420,314,147,167,1,27
261,be6b0d55-191a-42d0-a879-eeecc544dc05,36895395,5420,638,318,320,2,27
261,be6b0d55-191a-42d0-a879-eeecc544dc05,36895395,5420,746,652,94,5,27
261,be6b0d55-191a-42d0-a879-eeecc544dc05,36895395,5420,834,751,83,6,27
261,be6b0d55-191a-42d0-a879-eeecc544dc05,36895395,5420,910,836,74,7,27
261,be6b0d55-191a-42d0-a879-eeecc544dc05,36895395,5420,994,911,83,8,27
261,be6b0d55-191a-42d0-a879-eeecc544dc05,36895395,5420,1036,995,41,9,27
261,be6b0d55-191a-42d0-a879-eeecc544dc05,36895395,5420,1055,1037,18,10,27
261,be6b0d55-191a-42d0-a879-eeecc544dc05,36895395,5420,1058,1057,1,11,27
261,be6b0d55-191a-42d0-a879-eeecc544dc05,36895395,5420,1150,1071,79,17,27
261,be6b0d55-191a-42d0-a879-eeecc544dc05,36895395,5420,1167,1152,15,18,27
261,be6b0d55-191a-42d0-a879-eeecc544dc05,36895395,5420,1345,1170,175,21,27
261,be6b0d55-191a-42d0-a879-eeecc544dc05,36895395,5420,1414,1349,65,22,27
261,be6b0d55-191a-42d0-a879-eeecc544dc05,36895395,5420,1705,1416,289,23,27
261,be6b0d55-191a-42d0-a879-eeecc544dc05,36895395,5420,3341,1713,1628,26,27
261,be6b0d55-191a-42d0-a879-eeecc544dc05,36895395,5420,3364,3364,0,27,27
261,de464539-c74c-45d3-9b19-2aa06d91f421,36903865,7688,564,16,548,0,0
261,de464539-c74c-45d3-9b19-2aa06d91f421,36910391,4416,286,5,281,0,17
261,de464539-c74c-45d3-9b19-2aa06d91f421,36910391,4416,534,288,246,1,17
261,de464539-c74c-45d3-9b19-2aa06d91f421,36910391,4416,627,538,89,2,17
261,de464539-c74c-45d3-9b19-2aa06d91f421,36910391,4416,915,631,284,6,17
261,de464539-c74c-45d3-9b19-2aa06d91f421,36910391,4416,935,917,18,7,17
261,de464539-c74c-45d3-9b19-2aa06d91f421,36910391,4416,1363,937,426,8,17
261,de464539-c74c-45d3-9b19-2aa06d91f421,36910391,4416,1778,1380,398,13,17
261,de464539-c74c-45d3-9b19-2aa06d91f421,36910391,4416,2122,1782,340,14,17
261,de464539-c74c-45d3-9b19-2aa06d91f421,36910391,4416,2360,2159,201,15,17
261,de464539-c74c-45d3-9b19-2aa06d91f421,36910391,4416,2323,0,-2323,17,17
261,77f75bce-1d3b-465e-9938-efaa8b6936c6,36914884,4556,501,2,499,0,30
261,77f75bce-1d3b-465e-9938-efaa8b6936c6,36914884,4556,636,517,119,1,30
261,77f75bce-1d3b-465e-9938-efaa8b6936c6,36914884,4556,1114,655,459,11,30
261,77f75bce-1d3b-465e-9938-efaa8b6936c6,36914884,4556,1638,1123,515,12,30
261,77f75bce-1d3b-465e-9938-efaa8b6936c6,36914884,4556,883,47,836,21,30
261,77f75bce-1d3b-465e-9938-efaa8b6936c6,36914884,4556,1346,885,461,22,30
261,77f75bce-1d3b-465e-9938-efaa8b6936c6,36914884,4556,1255,0,-1255,30,30
259,21e01b49-50a0-4c48-ba07-011a51ee1bd7,36916606,3626,64,5,59,0,35
259,21e01b49-50a0-4c48-ba07-011a51ee1bd7,36916606,3626,181,66,115,2,35
259,21e01b49-50a0-4c48-ba07-011a51ee1bd7,36916606,3626,246,182,64,3,35
259,21e01b49-50a0-4c48-ba07-011a51ee1bd7,36916606,3626,259,247,12,4,35
259,21e01b49-50a0-4c48-ba07-011a51ee1bd7,36916606,3626,364,261,103,9,35
259,21e01b49-50a0-4c48-ba07-011a51ee1bd7,36916606,3626,483,367,116,10,35
259,21e01b49-50a0-4c48-ba07-011a51ee1bd7,36916606,3626,491,485,6,11,35
259,21e01b49-50a0-4c48-ba07-011a51ee1bd7,36916606,3626,641,492,149,18,35
259,21e01b49-50a0-4c48-ba07-011a51ee1bd7,36916606,3626,780,646,134,19,35
259,21e01b49-50a0-4c48-ba07-011a51ee1bd7,36916606,3626,859,784,75,20,35
259,21e01b49-50a0-4c48-ba07-011a51ee1bd7,36916606,3626,891,865,26,25,35
259,21e01b49-50a0-4c48-ba07-011a51ee1bd7,36916606,3626,1079,894,185,26,35
259,21e01b49-50a0-4c48-ba07-011a51ee1bd7,36916606,3626,1108,1081,27,27,35
259,21e01b49-50a0-4c48-ba07-011a51ee1bd7,36916606,3626,1193,1109,84,28,35
259,21e01b49-50a0-4c48-ba07-011a51ee1bd7,36916606,3626,1305,1194,111,29,35
259,21e01b49-50a0-4c48-ba07-011a51ee1bd7,36916606,3626,1309,1307,2,30,35
259,21e01b49-50a0-4c48-ba07-011a51ee1bd7,36916606,3626,1407,1311,96,34,35
259,21e01b49-50a0-4c48-ba07-011a51ee1bd7,36916606,3626,1559,1409,150,35,35
261,fe8d7db6-850f-4a8a-92fa-dda04935f86e,36920665,7512,212,11,201,0,31
261,fe8d7db6-850f-4a8a-92fa-dda04935f86e,36920665,7512,846,213,633,1,31
261,fe8d7db6-850f-4a8a-92fa-dda04935f86e,36920665,7512,1243,873,370,16,31
261,fe8d7db6-850f-4a8a-92fa-dda04935f86e,36920665,7512,1610,1261,349,17,31
261,fe8d7db6-850f-4a8a-92fa-dda04935f86e,36920665,7512,1754,1630,124,23,31
261,fe8d7db6-850f-4a8a-92fa-dda04935f86e,36920665,7512,2270,1812,458,24,31
261,fe8d7db6-850f-4a8a-92fa-dda04935f86e,36920665,7512,2585,2279,306,25,31
261,fe8d7db6-850f-4a8a-92fa-dda04935f86e,36920665,7512,3470,2639,831,26,31
261,fe8d7db6-850f-4a8a-92fa-dda04935f86e,36920665,7512,5456,3559,1897,27,31
261,fe8d7db6-850f-4a8a-92fa-dda04935f86e,36920665,7512,5442,5101,-341,30,31
261,fe8d7db6-850f-4a8a-92fa-dda04935f86e,36920665,7512,5099,5097,-2,31,31
261,fe8d7db6-850f-4a8a-92fa-dda04935f86e,36882292,12872,215,4,211,0,12
261,fe8d7db6-850f-4a8a-92fa-dda04935f86e,36882292,12872,261,219,42,1,12
261,fe8d7db6-850f-4a8a-92fa-dda04935f86e,36882292,12872,312,264,48,2,12
261,fe8d7db6-850f-4a8a-92fa-dda04935f86e,36882292,12872,394,313,81,3,12
261,fe8d7db6-850f-4a8a-92fa-dda04935f86e,36882292,12872,354,0,-354,5,12
261,fe8d7db6-850f-4a8a-92fa-dda04935f86e,36882292,12872,2,1,1,6,12
261,fe8d7db6-850f-4a8a-92fa-dda04935f86e,36882292,12872,1243,20,1223,8,12
261,fe8d7db6-850f-4a8a-92fa-dda04935f86e,36882292,12872,1424,1247,177,10,12
261,fe8d7db6-850f-4a8a-92fa-dda04935f86e,36882292,12872,1534,1426,108,11,12
261,fe8d7db6-850f-4a8a-92fa-dda04935f86e,36882292,12872,1541,1536,5,12,12
261,fe8d7db6-850f-4a8a-92fa-dda04935f86e,36912992,4792,266,6,260,0,42
261,fe8d7db6-850f-4a8a-92fa-dda04935f86e,36912992,4792,648,275,373,2,42
261,fe8d7db6-850f-4a8a-92fa-dda04935f86e,36912992,4792,816,661,155,9,42
261,fe8d7db6-850f-4a8a-92fa-dda04935f86e,36912992,4792,900,817,83,10,42
261,fe8d7db6-850f-4a8a-92fa-dda04935f86e,36912992,4792,1149,907,242,11,42
261,fe8d7db6-850f-4a8a-92fa-dda04935f86e,36912992,4792,1485,1151,334,12,42
261,fe8d7db6-850f-4a8a-92fa-dda04935f86e,36912992,4792,1603,1504,99,13,42
261,fe8d7db6-850f-4a8a-92fa-dda04935f86e,36912992,4792,1992,1611,381,15,42
261,fe8d7db6-850f-4a8a-92fa-dda04935f86e,36912992,4792,2196,1997,199,19,42
261,fe8d7db6-850f-4a8a-92fa-dda04935f86e,36912992,4792,2550,2197,353,20,42
261,fe8d7db6-850f-4a8a-92fa-dda04935f86e,36912992,4792,2736,2582,154,27,42
261,fe8d7db6-850f-4a8a-92fa-dda04935f86e,36912992,4792,2729,2545,-184,42,42
261,fe8d7db6-850f-4a8a-92fa-dda04935f86e,36912572,4472,17,17,0,0,9
261,fe8d7db6-850f-4a8a-92fa-dda04935f86e,36912572,4472,247,44,203,1,9
261,fe8d7db6-850f-4a8a-92fa-dda04935f86e,36912572,4472,257,248,9,2,9
261,fe8d7db6-850f-4a8a-92fa-dda04935f86e,36912572,4472,413,258,155,3,9
261,fe8d7db6-850f-4a8a-92fa-dda04935f86e,36912572,4472,519,415,104,4,9
261,fe8d7db6-850f-4a8a-92fa-dda04935f86e,36912572,4472,700,523,177,5,9
261,fe8d7db6-850f-4a8a-92fa-dda04935f86e,36912572,4472,1811,716,1095,8,9
261,fe8d7db6-850f-4a8a-92fa-dda04935f86e,36912572,4472,2416,1818,598,9,9
24,157a2356-044c-4c76-97e7-571d3f481320,36927523,3212,5,5,0,0,41
24,157a2356-044c-4c76-97e7-571d3f481320,36927523,3212,281,12,269,1,41
24,157a2356-044c-4c76-97e7-571d3f481320,36927523,3212,299,284,15,2,41
24,157a2356-044c-4c76-97e7-571d3f481320,36927523,3212,495,304,191,14,41
24,157a2356-044c-4c76-97e7-571d3f481320,36927523,3212,576,496,80,15,41
24,157a2356-044c-4c76-97e7-571d3f481320,36927523,3212,687,580,107,22,41
24,157a2356-044c-4c76-97e7-571d3f481320,36927523,3212,750,690,60,23,41
24,157a2356-044c-4c76-97e7-571d3f481320,36927523,3212,833,752,81,32,41
24,157a2356-044c-4c76-97e7-571d3f481320,36927523,3212,1072,837,235,33,41
24,157a2356-044c-4c76-97e7-571d3f481320,36927523,3212,1344,1085,259,34,41
24,157a2356-044c-4c76-97e7-571d3f481320,36927523,3212,1419,1346,73,35,41
24,157a2356-044c-4c76-97e7-571d3f481320,36927523,3212,1432,1421,11,36,41
24,157a2356-044c-4c76-97e7-571d3f481320,36927523,3212,1468,1434,34,40,41
24,157a2356-044c-4c76-97e7-571d3f481320,36927523,3212,1629,1472,157,41,41
261,4569a65a-f017-4a0b-b460-47c055243be1,36955531,6428,757,6,751,0,16
261,4569a65a-f017-4a0b-b460-47c055243be1,36955531,6428,1076,771,305,1,16
261,4569a65a-f017-4a0b-b460-47c055243be1,36955531,6428,1946,1080,866,2,16
261,4569a65a-f017-4a0b-b460-47c055243be1,36955531,6428,2546,1963,583,5,16
261,4569a65a-f017-4a0b-b460-47c055243be1,36955531,6428,3276,2565,711,6,16
261,4569a65a-f017-4a0b-b460-47c055243be1,36955531,6428,3936,3335,601,7,16
261,4569a65a-f017-4a0b-b460-47c055243be1,36955531,6428,4372,3940,432,16,16
261,4569a65a-f017-4a0b-b460-47c055243be1,36961201,5928,682,25,657,0,19
261,4569a65a-f017-4a0b-b460-47c055243be1,36961201,5928,832,687,145,1,19
261,4569a65a-f017-4a0b-b460-47c055243be1,36961201,5928,1162,838,324,2,19
261,4569a65a-f017-4a0b-b460-47c055243be1,36961201,5928,1339,1168,171,3,19
261,4569a65a-f017-4a0b-b460-47c055243be1,36961201,5928,1406,1343,63,4,19
261,4569a65a-f017-4a0b-b460-47c055243be1,36961201,5928,1716,1410,306,9,19
261,4569a65a-f017-4a0b-b460-47c055243be1,36961201,5928,1789,1723,66,10,19
261,4569a65a-f017-4a0b-b460-47c055243be1,36961201,5928,1834,1790,44,11,19
261,4569a65a-f017-4a0b-b460-47c055243be1,36961201,5928,1881,1836,45,12,19
261,4569a65a-f017-4a0b-b460-47c055243be1,36961201,5928,1961,1896,65,18,19
261,4569a65a-f017-4a0b-b460-47c055243be1,36961201,5928,3872,2153,1719,19,19
261,4569a65a-f017-4a0b-b460-47c055243be1,36941960,3492,93,11,82,0,3
261,4569a65a-f017-4a0b-b460-47c055243be1,36941960,3492,500,114,386,1,3
261,4569a65a-f017-4a0b-b460-47c055243be1,36941960,3492,547,505,42,2,3
261,4569a65a-f017-4a0b-b460-47c055243be1,36941960,3492,895,548,347,3,3
261,4569a65a-f017-4a0b-b460-47c055243be1,36951279,3432,669,37,632,0,1
261,4569a65a-f017-4a0b-b460-47c055243be1,36951279,3432,805,712,93,1,1
259,0e81172b-0532-4f3c-a57a-e2cf20ce109f,37003819,3672,43,9,34,0,1
259,0e81172b-0532-4f3c-a57a-e2cf20ce109f,37003819,3672,101,47,54,1,1
125,5d64a657-147f-481d-9147-45ee014a633f,37057689,2508,72,4,68,0,178
125,5d64a657-147f-481d-9147-45ee014a633f,37057689,2508,656,69,587,1,178
125,5d64a657-147f-481d-9147-45ee014a633f,37057689,2508,661,657,4,2,178
125,5d64a657-147f-481d-9147-45ee014a633f,37057689,2508,1079,675,404,143,178
125,5d64a657-147f-481d-9147-45ee014a633f,37057689,2508,1092,1080,12,144,178
125,5d64a657-147f-481d-9147-45ee014a633f,37057689,2508,1092,1080,-12,144,178
125,5d64a657-147f-481d-9147-45ee014a633f,37057689,2508,1079,1066,-13,145,178
125,5d64a657-147f-481d-9147-45ee014a633f,37057689,2508,1341,1072,269,177,178
125,5d64a657-147f-481d-9147-45ee014a633f,37057689,2508,1341,1248,93,178,178
125,5d64a657-147f-481d-9147-45ee014a633f,37085244,1367,200,197,-3,0,2
125,5d64a657-147f-481d-9147-45ee014a633f,37085244,1367,195,195,0,1,2
125,5d64a657-147f-481d-9147-45ee014a633f,37085244,1367,200,194,6,2,2
259,0c1b6eb4-7526-4dbf-aecb-ee20e7492d7a,37103039,2018,125,8,117,0,10
259,0c1b6eb4-7526-4dbf-aecb-ee20e7492d7a,37103039,2018,263,131,132,1,10
259,0c1b6eb4-7526-4dbf-aecb-ee20e7492d7a,37103039,2018,566,270,296,2,10
259,0c1b6eb4-7526-4dbf-aecb-ee20e7492d7a,37103039,2018,581,571,10,7,10
259,0c1b6eb4-7526-4dbf-aecb-ee20e7492d7a,37103039,2018,723,599,124,8,10
259,0c1b6eb4-7526-4dbf-aecb-ee20e7492d7a,37103039,2018,817,734,83,9,10
259,0c1b6eb4-7526-4dbf-aecb-ee20e7492d7a,37103039,2018,908,818,90,10,10
259,4d3a069a-b7e5-4964-8b94-fdb4f9b13a29,37107450,5626,91,2,89,0,29
259,4d3a069a-b7e5-4964-8b94-fdb4f9b13a29,37107450,5626,151,93,58,4,29
259,4d3a069a-b7e5-4964-8b94-fdb4f9b13a29,37107450,5626,182,154,28,10,29
259,4d3a069a-b7e5-4964-8b94-fdb4f9b13a29,37107450,5626,217,174,43,11,29
259,4d3a069a-b7e5-4964-8b94-fdb4f9b13a29,37107450,5626,350,229,121,12,29
259,4d3a069a-b7e5-4964-8b94-fdb4f9b13a29,37107450,5626,506,361,145,16,29
259,4d3a069a-b7e5-4964-8b94-fdb4f9b13a29,37107450,5626,529,508,21,23,29
259,4d3a069a-b7e5-4964-8b94-fdb4f9b13a29,37107450,5626,554,532,22,24,29
259,4d3a069a-b7e5-4964-8b94-fdb4f9b13a29,37107450,5626,714,554,160,26,29
259,4d3a069a-b7e5-4964-8b94-fdb4f9b13a29,37107450,5626,1632,730,902,28,29
259,4d3a069a-b7e5-4964-8b94-fdb4f9b13a29,37107450,5626,2235,1751,484,29,29
259,4d3a069a-b7e5-4964-8b94-fdb4f9b13a29,37109170,4138,15,15,0,0,8
259,4d3a069a-b7e5-4964-8b94-fdb4f9b13a29,37109170,4138,222,30,192,1,8
259,4d3a069a-b7e5-4964-8b94-fdb4f9b13a29,37109170,4138,331,228,103,2,8
259,4d3a069a-b7e5-4964-8b94-fdb4f9b13a29,37109170,4138,409,334,75,8,8
259,4d3a069a-b7e5-4964-8b94-fdb4f9b13a29,37107805,2902,165,1,164,0,12
259,4d3a069a-b7e5-4964-8b94-fdb4f9b13a29,37107805,2902,193,165,28,1,12
259,4d3a069a-b7e5-4964-8b94-fdb4f9b13a29,37107805,2902,275,201,74,2,12
259,4d3a069a-b7e5-4964-8b94-fdb4f9b13a29,37107805,2902,364,279,85,5,12
259,4d3a069a-b7e5-4964-8b94-fdb4f9b13a29,37107805,2902,377,363,14,6,12
259,4d3a069a-b7e5-4964-8b94-fdb4f9b13a29,37107805,2902,812,378,434,7,12
259,4d3a069a-b7e5-4964-8b94-fdb4f9b13a29,37107805,2902,837,814,23,8,12
259,4d3a069a-b7e5-4964-8b94-fdb4f9b13a29,37107805,2902,989,844,145,11,12
259,4d3a069a-b7e5-4964-8b94-fdb4f9b13a29,37107805,2902,1792,990,802,12,12
259,4d3a069a-b7e5-4964-8b94-fdb4f9b13a29,37107945,1844,93,9,84,0,9
259,4d3a069a-b7e5-4964-8b94-fdb4f9b13a29,37107945,1844,122,95,27,1,9
259,4d3a069a-b7e5-4964-8b94-fdb4f9b13a29,37107945,1844,151,125,26,2,9
259,4d3a069a-b7e5-4964-8b94-fdb4f9b13a29,37107945,1844,146,142,-4,3,9
259,4d3a069a-b7e5-4964-8b94-fdb4f9b13a29,37107945,1844,199,154,45,4,9
259,4d3a069a-b7e5-4964-8b94-fdb4f9b13a29,37107945,1844,310,200,110,5,9
259,4d3a069a-b7e5-4964-8b94-fdb4f9b13a29,37107945,1844,327,311,16,6,9
259,4d3a069a-b7e5-4964-8b94-fdb4f9b13a29,37107945,1844,530,338,192,7,9
259,4d3a069a-b7e5-4964-8b94-fdb4f9b13a29,37107945,1844,661,533,128,8,9
259,4d3a069a-b7e5-4964-8b94-fdb4f9b13a29,37107945,1844,734,698,36,9,9
259,4d3a069a-b7e5-4964-8b94-fdb4f9b13a29,37109807,2604,41,4,37,0,25
259,4d3a069a-b7e5-4964-8b94-fdb4f9b13a29,37109807,2604,225,46,179,1,25
259,4d3a069a-b7e5-4964-8b94-fdb4f9b13a29,37109807,2604,230,219,-11,2,25
259,4d3a069a-b7e5-4964-8b94-fdb4f9b13a29,37109807,2604,226,226,0,3,25
259,4d3a069a-b7e5-4964-8b94-fdb4f9b13a29,37109807,2604,350,233,117,4,25
259,4d3a069a-b7e5-4964-8b94-fdb4f9b13a29,37109807,2604,1277,350,927,5,25
259,4d3a069a-b7e5-4964-8b94-fdb4f9b13a29,37109807,2604,1270,1242,-28,6,25
259,4d3a069a-b7e5-4964-8b94-fdb4f9b13a29,37109807,2604,1221,1085,-136,7,25
259,4d3a069a-b7e5-4964-8b94-fdb4f9b13a29,37109807,2604,1081,1048,-33,8,25
259,4d3a069a-b7e5-4964-8b94-fdb4f9b13a29,37109807,2604,1096,1061,35,15,25
259,4d3a069a-b7e5-4964-8b94-fdb4f9b13a29,37109807,2604,1384,1100,284,18,25
259,4d3a069a-b7e5-4964-8b94-fdb4f9b13a29,37109807,2604,1387,1381,6,19,25
259,4d3a069a-b7e5-4964-8b94-fdb4f9b13a29,37109807,2604,1489,1391,98,24,25
259,4d3a069a-b7e5-4964-8b94-fdb4f9b13a29,37109807,2604,1494,1488,6,25,25
259,82757cc2-2141-4796-be3d-95eaac2e43ed,37232170,3958,58,4,54,0,17
259,82757cc2-2141-4796-be3d-95eaac2e43ed,37232170,3958,146,61,85,7,17
259,82757cc2-2141-4796-be3d-95eaac2e43ed,37232170,3958,263,147,116,8,17
259,82757cc2-2141-4796-be3d-95eaac2e43ed,37232170,3958,324,267,57,9,17
259,82757cc2-2141-4796-be3d-95eaac2e43ed,37232170,3958,401,331,70,10,17
259,82757cc2-2141-4796-be3d-95eaac2e43ed,37232170,3958,720,409,311,11,17
259,82757cc2-2141-4796-be3d-95eaac2e43ed,37232170,3958,762,728,34,12,17
259,82757cc2-2141-4796-be3d-95eaac2e43ed,37232170,3958,813,763,50,13,17
259,82757cc2-2141-4796-be3d-95eaac2e43ed,37232170,3958,829,814,15,14,17
259,82757cc2-2141-4796-be3d-95eaac2e43ed,37232170,3958,919,831,88,16,17
259,82757cc2-2141-4796-be3d-95eaac2e43ed,37232170,3958,1995,938,1057,17,17
259,82757cc2-2141-4796-be3d-95eaac2e43ed,37237513,5952,34,2,32,0,5
259,82757cc2-2141-4796-be3d-95eaac2e43ed,37237513,5952,269,46,223,1,5
259,82757cc2-2141-4796-be3d-95eaac2e43ed,37237513,5952,281,271,10,2,5
259,82757cc2-2141-4796-be3d-95eaac2e43ed,37237513,5952,815,286,529,4,5
259,82757cc2-2141-4796-be3d-95eaac2e43ed,37237513,5952,869,838,31,5,5
259,82757cc2-2141-4796-be3d-95eaac2e43ed,37239677,2402,224,3,221,0,14
259,82757cc2-2141-4796-be3d-95eaac2e43ed,37239677,2402,241,229,12,1,14
259,82757cc2-2141-4796-be3d-95eaac2e43ed,37239677,2402,720,296,424,7,14
259,82757cc2-2141-4796-be3d-95eaac2e43ed,37239677,2402,1186,797,389,8,14
259,82757cc2-2141-4796-be3d-95eaac2e43ed,37239677,2402,1292,1210,82,14,14
259,82757cc2-2141-4796-be3d-95eaac2e43ed,37239683,1138,28,3,25,0,0
267,2cd2f888-7c4c-4012-8477-eb724cea0809,37265840,6352,2538,26,2512,0,44
267,2cd2f888-7c4c-4012-8477-eb724cea0809,37265840,6352,2824,2566,258,1,44
267,2cd2f888-7c4c-4012-8477-eb724cea0809,37265840,6352,4128,2882,1246,2,44
267,2cd2f888-7c4c-4012-8477-eb724cea0809,37265840,6352,4085,3484,-601,4,44
267,2cd2f888-7c4c-4012-8477-eb724cea0809,37265840,6352,3482,3468,-14,5,44
267,2cd2f888-7c4c-4012-8477-eb724cea0809,37265840,6352,3664,3477,187,27,44
267,2cd2f888-7c4c-4012-8477-eb724cea0809,37265840,6352,3774,3666,108,28,44
267,2cd2f888-7c4c-4012-8477-eb724cea0809,37265840,6352,3901,3784,117,33,44
267,2cd2f888-7c4c-4012-8477-eb724cea0809,37265840,6352,4091,3910,181,37,44
267,2cd2f888-7c4c-4012-8477-eb724cea0809,37265840,6352,4093,4092,1,38,44
267,2cd2f888-7c4c-4012-8477-eb724cea0809,37265840,6352,4128,4103,25,39,44
267,2cd2f888-7c4c-4012-8477-eb724cea0809,37265840,6352,4104,1595,-2509,40,44
267,2cd2f888-7c4c-4012-8477-eb724cea0809,37265840,6352,1592,0,-1592,41,44
267,2cd2f888-7c4c-4012-8477-eb724cea0809,37265840,6352,566,11,555,44,44
267,2cd2f888-7c4c-4012-8477-eb724cea0809,37266075,5128,481,16,465,0,37
267,2cd2f888-7c4c-4012-8477-eb724cea0809,37266075,5128,978,491,487,1,37
267,2cd2f888-7c4c-4012-8477-eb724cea0809,37266075,5128,1034,979,55,2,37
267,2cd2f888-7c4c-4012-8477-eb724cea0809,37266075,5128,1404,1042,362,10,37
267,2cd2f888-7c4c-4012-8477-eb724cea0809,37266075,5128,1829,1408,421,11,37
267,2cd2f888-7c4c-4012-8477-eb724cea0809,37266075,5128,1904,1835,69,12,37
267,2cd2f888-7c4c-4012-8477-eb724cea0809,37266075,5128,1895,1895,0,14,37
267,2cd2f888-7c4c-4012-8477-eb724cea0809,37266075,5128,2197,1903,294,15,37
267,2cd2f888-7c4c-4012-8477-eb724cea0809,37266075,5128,2381,2200,181,16,37
267,2cd2f888-7c4c-4012-8477-eb724cea0809,37266075,5128,2565,2392,173,24,37
267,2cd2f888-7c4c-4012-8477-eb724cea0809,37266075,5128,2579,2567,12,25,37
267,2cd2f888-7c4c-4012-8477-eb724cea0809,37266075,5128,2695,2581,114,26,37
267,2cd2f888-7c4c-4012-8477-eb724cea0809,37266075,5128,2904,2700,204,32,37
267,2cd2f888-7c4c-4012-8477-eb724cea0809,37266075,5128,2904,2903,1,34,37
267,2cd2f888-7c4c-4012-8477-eb724cea0809,37266075,5128,2798,863,-1935,36,37
267,2cd2f888-7c4c-4012-8477-eb724cea0809,37266075,5128,842,138,-704,37,37
267,e7dec2c6-c445-4cbb-ba16-868b36bebbf6,37283869,15068,308,2,306,0,29
267,e7dec2c6-c445-4cbb-ba16-868b36bebbf6,37283869,15068,530,354,176,1,29
267,e7dec2c6-c445-4cbb-ba16-868b36bebbf6,37283869,15068,1199,546,653,3,29
267,e7dec2c6-c445-4cbb-ba16-868b36bebbf6,37283869,15068,1557,1201,356,4,29
267,e7dec2c6-c445-4cbb-ba16-868b36bebbf6,37283869,15068,1740,1558,182,5,29
267,e7dec2c6-c445-4cbb-ba16-868b36bebbf6,37283869,15068,2275,1772,503,8,29
267,e7dec2c6-c445-4cbb-ba16-868b36bebbf6,37283869,15068,3493,2318,1175,10,29
267,e7dec2c6-c445-4cbb-ba16-868b36bebbf6,37283869,15068,4092,3561,531,11,29
267,e7dec2c6-c445-4cbb-ba16-868b36bebbf6,37283869,15068,5101,4146,955,12,29
267,e7dec2c6-c445-4cbb-ba16-868b36bebbf6,37283869,15068,5727,5102,625,13,29
267,e7dec2c6-c445-4cbb-ba16-868b36bebbf6,37283869,15068,6783,5812,971,14,29
267,e7dec2c6-c445-4cbb-ba16-868b36bebbf6,37283869,15068,7429,6808,621,15,29
267,e7dec2c6-c445-4cbb-ba16-868b36bebbf6,37283869,15068,7648,7430,218,17,29
267,e7dec2c6-c445-4cbb-ba16-868b36bebbf6,37283869,15068,8512,7656,856,18,29
267,e7dec2c6-c445-4cbb-ba16-868b36bebbf6,37283869,15068,8695,8535,160,19,29
267,e7dec2c6-c445-4cbb-ba16-868b36bebbf6,37283869,15068,8972,8703,269,26,29
267,e7dec2c6-c445-4cbb-ba16-868b36bebbf6,37283869,15068,10565,9006,1559,27,29
267,e7dec2c6-c445-4cbb-ba16-868b36bebbf6,37283869,15068,12327,10574,1753,28,29
267,e7dec2c6-c445-4cbb-ba16-868b36bebbf6,37283869,15068,12331,0,-12331,29,29
267,e7dec2c6-c445-4cbb-ba16-868b36bebbf6,37284033,4272,115,13,102,0,6
267,e7dec2c6-c445-4cbb-ba16-868b36bebbf6,37284033,4272,288,118,170,1,6
267,e7dec2c6-c445-4cbb-ba16-868b36bebbf6,37284033,4272,382,289,93,2,6
267,e7dec2c6-c445-4cbb-ba16-868b36bebbf6,37284033,4272,419,384,35,3,6
267,e7dec2c6-c445-4cbb-ba16-868b36bebbf6,37284033,4272,489,420,69,4,6
267,e7dec2c6-c445-4cbb-ba16-868b36bebbf6,37284033,4272,663,490,173,5,6
267,e7dec2c6-c445-4cbb-ba16-868b36bebbf6,37284033,4272,709,671,38,6,6
267,db9b32a3-0a9d-4443-97d9-18f1b639d2c2,37312225,5824,300,33,267,0,19
267,db9b32a3-0a9d-4443-97d9-18f1b639d2c2,37312225,5824,434,327,107,1,19
267,db9b32a3-0a9d-4443-97d9-18f1b639d2c2,37312225,5824,576,421,155,2,19
267,db9b32a3-0a9d-4443-97d9-18f1b639d2c2,37312225,5824,695,586,109,3,19
267,db9b32a3-0a9d-4443-97d9-18f1b639d2c2,37312225,5824,934,702,232,4,19
267,db9b32a3-0a9d-4443-97d9-18f1b639d2c2,37312225,5824,1033,940,93,5,19
267,db9b32a3-0a9d-4443-97d9-18f1b639d2c2,37312225,5824,1142,1035,107,6,19
267,db9b32a3-0a9d-4443-97d9-18f1b639d2c2,37312225,5824,1147,1143,4,7,19
267,db9b32a3-0a9d-4443-97d9-18f1b639d2c2,37312225,5824,1526,1148,378,8,19
267,db9b32a3-0a9d-4443-97d9-18f1b639d2c2,37312225,5824,1596,1528,68,9,19
267,db9b32a3-0a9d-4443-97d9-18f1b639d2c2,37312225,5824,2125,1598,527,10,19
267,db9b32a3-0a9d-4443-97d9-18f1b639d2c2,37312225,5824,2327,2132,195,13,19
267,db9b32a3-0a9d-4443-97d9-18f1b639d2c2,37312225,5824,2382,2339,43,14,19
267,db9b32a3-0a9d-4443-97d9-18f1b639d2c2,37312225,5824,2542,2384,158,15,19
267,db9b32a3-0a9d-4443-97d9-18f1b639d2c2,37312225,5824,3446,2545,901,16,19
267,db9b32a3-0a9d-4443-97d9-18f1b639d2c2,37312225,5824,3600,3461,139,17,19
267,db9b32a3-0a9d-4443-97d9-18f1b639d2c2,37312225,5824,3592,646,-2946,18,19
267,db9b32a3-0a9d-4443-97d9-18f1b639d2c2,37312225,5824,626,480,-146,19,19
267,db9b32a3-0a9d-4443-97d9-18f1b639d2c2,37322599,4156,55,4,51,0,20
267,db9b32a3-0a9d-4443-97d9-18f1b639d2c2,37322599,4156,143,57,86,1,20
267,db9b32a3-0a9d-4443-97d9-18f1b639d2c2,37322599,4156,185,145,40,2,20
267,db9b32a3-0a9d-4443-97d9-18f1b639d2c2,37322599,4156,414,186,228,3,20
267,db9b32a3-0a9d-4443-97d9-18f1b639d2c2,37322599,4156,511,417,94,4,20
267,db9b32a3-0a9d-4443-97d9-18f1b639d2c2,37322599,4156,713,512,201,5,20
267,db9b32a3-0a9d-4443-97d9-18f1b639d2c2,37322599,4156,755,724,31,6,20
267,db9b32a3-0a9d-4443-97d9-18f1b639d2c2,37322599,4156,814,758,56,7,20
267,db9b32a3-0a9d-4443-97d9-18f1b639d2c2,37322599,4156,998,815,183,8,20
267,db9b32a3-0a9d-4443-97d9-18f1b639d2c2,37322599,4156,1346,1010,336,9,20
267,db9b32a3-0a9d-4443-97d9-18f1b639d2c2,37322599,4156,1456,1347,109,10,20
267,db9b32a3-0a9d-4443-97d9-18f1b639d2c2,37322599,4156,1817,1466,351,11,20
267,db9b32a3-0a9d-4443-97d9-18f1b639d2c2,37322599,4156,1932,1818,114,12,20
267,db9b32a3-0a9d-4443-97d9-18f1b639d2c2,37322599,4156,1929,1922,-7,18,20
267,db9b32a3-0a9d-4443-97d9-18f1b639d2c2,37322599,4156,1932,1932,0,20,20
267,f5f71647-a1b0-46fb-a112-0ff452e5fc93,37329191,5032,97,7,90,0,40
267,f5f71647-a1b0-46fb-a112-0ff452e5fc93,37329191,5032,573,124,449,1,40
267,f5f71647-a1b0-46fb-a112-0ff452e5fc93,37329191,5032,752,591,161,2,40
267,f5f71647-a1b0-46fb-a112-0ff452e5fc93,37329191,5032,2691,755,1936,12,40
267,f5f71647-a1b0-46fb-a112-0ff452e5fc93,37329191,5032,2808,2714,94,13,40
267,f5f71647-a1b0-46fb-a112-0ff452e5fc93,37329191,5032,2802,2744,-58,14,40
267,f5f71647-a1b0-46fb-a112-0ff452e5fc93,37329191,5032,2733,2494,-239,15,40
267,f5f71647-a1b0-46fb-a112-0ff452e5fc93,37329191,5032,2493,2487,-6,16,40
267,f5f71647-a1b0-46fb-a112-0ff452e5fc93,37329191,5032,2465,2094,-371,18,40
267,f5f71647-a1b0-46fb-a112-0ff452e5fc93,37329191,5032,2091,2080,-11,19,40
267,f5f71647-a1b0-46fb-a112-0ff452e5fc93,37329191,5032,2561,2083,478,24,40
267,f5f71647-a1b0-46fb-a112-0ff452e5fc93,37329191,5032,2569,2564,5,25,40
267,f5f71647-a1b0-46fb-a112-0ff452e5fc93,37329191,5032,2808,2591,217,30,40
267,f5f71647-a1b0-46fb-a112-0ff452e5fc93,37329191,5032,2808,2807,1,35,40
267,f5f71647-a1b0-46fb-a112-0ff452e5fc93,37329191,5032,2808,2807,1,38,40
267,f5f71647-a1b0-46fb-a112-0ff452e5fc93,37329191,5032,2806,2787,-19,39,40
267,f5f71647-a1b0-46fb-a112-0ff452e5fc93,37329191,5032,2808,2806,2,40,40
268,d9eb0cea-94da-4fe3-8262-47bf40ebf89b,37314230,2330,92,14,78,0,23
268,d9eb0cea-94da-4fe3-8262-47bf40ebf89b,37314230,2330,450,122,328,1,23
268,d9eb0cea-94da-4fe3-8262-47bf40ebf89b,37314230,2330,450,369,81,23,23
263,6970301e-0799-49ef-b019-a06e3426a117,37356873,17024,582,25,557,0,5
263,6970301e-0799-49ef-b019-a06e3426a117,37356873,17024,491,84,-407,1,5
263,6970301e-0799-49ef-b019-a06e3426a117,37356873,17024,37,0,-37,2,5
263,6970301e-0799-49ef-b019-a06e3426a117,37356873,17024,884,146,738,3,5
263,6970301e-0799-49ef-b019-a06e3426a117,37356873,17024,1839,916,923,4,5
263,6970301e-0799-49ef-b019-a06e3426a117,37356873,17024,1840,1840,0,5,5
263,6970301e-0799-49ef-b019-a06e3426a117,37352326,13452,851,15,836,0,27
263,6970301e-0799-49ef-b019-a06e3426a117,37352326,13452,1097,881,216,1,27
263,6970301e-0799-49ef-b019-a06e3426a117,37352326,13452,1404,1229,175,2,27
263,6970301e-0799-49ef-b019-a06e3426a117,37352326,13452,3506,1412,2094,7,27
263,6970301e-0799-49ef-b019-a06e3426a117,37352326,13452,3477,2761,-716,8,27
263,6970301e-0799-49ef-b019-a06e3426a117,37352326,13452,3162,2782,380,10,27
263,6970301e-0799-49ef-b019-a06e3426a117,37352326,13452,3291,3193,98,11,27
263,6970301e-0799-49ef-b019-a06e3426a117,37352326,13452,3716,3356,360,16,27
263,6970301e-0799-49ef-b019-a06e3426a117,37352326,13452,3935,3726,209,18,27
263,6970301e-0799-49ef-b019-a06e3426a117,37352326,13452,4178,3949,229,20,27
263,6970301e-0799-49ef-b019-a06e3426a117,37352326,13452,4869,4205,664,22,27
263,6970301e-0799-49ef-b019-a06e3426a117,37352326,13452,5438,4886,552,23,27
263,6970301e-0799-49ef-b019-a06e3426a117,37352326,13452,6128,5441,687,24,27
263,6970301e-0799-49ef-b019-a06e3426a117,37352326,13452,8351,6129,2222,25,27
263,6970301e-0799-49ef-b019-a06e3426a117,37352326,13452,10409,8354,2055,26,27
263,6970301e-0799-49ef-b019-a06e3426a117,37352326,13452,10549,10426,123,27,27
125,688f0ba0-e3e8-40b2-b1fc-e8547e480fac,37351342,10455,513,6,507,0,11
125,688f0ba0-e3e8-40b2-b1fc-e8547e480fac,37351342,10455,526,316,-210,1,11
125,688f0ba0-e3e8-40b2-b1fc-e8547e480fac,37351342,10455,345,342,-3,2,11
125,688f0ba0-e3e8-40b2-b1fc-e8547e480fac,37351342,10455,548,359,189,7,11
125,688f0ba0-e3e8-40b2-b1fc-e8547e480fac,37351342,10455,4356,572,3784,8,11
125,688f0ba0-e3e8-40b2-b1fc-e8547e480fac,37351342,10455,4801,2683,-2118,9,11
125,688f0ba0-e3e8-40b2-b1fc-e8547e480fac,37351342,10455,2882,2734,148,10,11
125,688f0ba0-e3e8-40b2-b1fc-e8547e480fac,37351342,10455,3488,2937,551,11,11
125,688f0ba0-e3e8-40b2-b1fc-e8547e480fac,37357574,2982,610,14,596,0,0
267,4c07055b-1392-4fd9-9778-5f5920364123,37387162,7844,94,5,89,0,12
267,4c07055b-1392-4fd9-9778-5f5920364123,37387162,7844,851,99,752,1,12
267,4c07055b-1392-4fd9-9778-5f5920364123,37387162,7844,930,857,73,2,12
267,4c07055b-1392-4fd9-9778-5f5920364123,37387162,7844,1004,932,72,3,12
267,4c07055b-1392-4fd9-9778-5f5920364123,37387162,7844,1062,1006,56,4,12
267,4c07055b-1392-4fd9-9778-5f5920364123,37387162,7844,1411,1068,343,6,12
267,4c07055b-1392-4fd9-9778-5f5920364123,37387162,7844,2194,1413,781,8,12
267,4c07055b-1392-4fd9-9778-5f5920364123,37387162,7844,2234,2201,33,9,12
267,4c07055b-1392-4fd9-9778-5f5920364123,37387162,7844,2826,2237,589,10,12
267,4c07055b-1392-4fd9-9778-5f5920364123,37387162,7844,4318,2828,1490,11,12
267,4c07055b-1392-4fd9-9778-5f5920364123,37387162,7844,5620,4326,1294,12,12
267,4c07055b-1392-4fd9-9778-5f5920364123,37381477,8488,346,18,328,0,36
267,4c07055b-1392-4fd9-9778-5f5920364123,37381477,8488,350,348,2,1,36
267,4c07055b-1392-4fd9-9778-5f5920364123,37381477,8488,586,364,222,8,36
267,4c07055b-1392-4fd9-9778-5f5920364123,37381477,8488,628,590,38,9,36
267,4c07055b-1392-4fd9-9778-5f5920364123,37381477,8488,667,635,32,14,36
267,4c07055b-1392-4fd9-9778-5f5920364123,37381477,8488,884,669,215,15,36
267,4c07055b-1392-4fd9-9778-5f5920364123,37381477,8488,1170,887,283,16,36
267,4c07055b-1392-4fd9-9778-5f5920364123,37381477,8488,1178,1173,5,17,36
267,4c07055b-1392-4fd9-9778-5f5920364123,37381477,8488,1390,1182,208,18,36
267,4c07055b-1392-4fd9-9778-5f5920364123,37381477,8488,1440,1391,49,19,36
267,4c07055b-1392-4fd9-9778-5f5920364123,37381477,8488,1535,1452,83,24,36
267,4c07055b-1392-4fd9-9778-5f5920364123,37381477,8488,1865,1548,317,25,36
267,4c07055b-1392-4fd9-9778-5f5920364123,37381477,8488,2163,1881,282,26,36
267,4c07055b-1392-4fd9-9778-5f5920364123,37381477,8488,3661,2166,1495,27,36
267,4c07055b-1392-4fd9-9778-5f5920364123,37381477,8488,3897,3687,210,28,36
267,4c07055b-1392-4fd9-9778-5f5920364123,37381477,8488,3931,3900,31,33,36
267,4c07055b-1392-4fd9-9778-5f5920364123,37381477,8488,3986,3932,54,34,36
267,4c07055b-1392-4fd9-9778-5f5920364123,37381477,8488,5493,3991,1502,35,36
267,4c07055b-1392-4fd9-9778-5f5920364123,37381477,8488,6264,5517,747,36,36
259,58fb0ded-358a-4ed6-acce-152b70976206,37436676,5928,55,1,54,0,55
259,58fb0ded-358a-4ed6-acce-152b70976206,37436676,5928,65,57,8,1,55
259,58fb0ded-358a-4ed6-acce-152b70976206,37436676,5928,139,73,66,9,55
259,58fb0ded-358a-4ed6-acce-152b70976206,37436676,5928,180,147,33,12,55
259,58fb0ded-358a-4ed6-acce-152b70976206,37436676,5928,191,181,10,13,55
259,58fb0ded-358a-4ed6-acce-152b70976206,37436676,5928,199,194,5,15,55
259,58fb0ded-358a-4ed6-acce-152b70976206,37436676,5928,220,200,20,16,55
259,58fb0ded-358a-4ed6-acce-152b70976206,37436676,5928,248,221,27,17,55
259,58fb0ded-358a-4ed6-acce-152b70976206,37436676,5928,1084,252,832,19,55
259,58fb0ded-358a-4ed6-acce-152b70976206,37436676,5928,1065,1063,-2,20,55
259,58fb0ded-358a-4ed6-acce-152b70976206,37436676,5928,1065,1063,2,20,55
259,58fb0ded-358a-4ed6-acce-152b70976206,37436676,5928,1115,1072,43,28,55
259,58fb0ded-358a-4ed6-acce-152b70976206,37436676,5928,1185,1118,67,29,55
259,58fb0ded-358a-4ed6-acce-152b70976206,37436676,5928,1273,1273,0,32,55
259,58fb0ded-358a-4ed6-acce-152b70976206,37436676,5928,1316,1285,31,33,55
259,58fb0ded-358a-4ed6-acce-152b70976206,37436676,5928,1363,1323,40,34,55
259,58fb0ded-358a-4ed6-acce-152b70976206,37436676,5928,1390,1364,26,36,55
259,58fb0ded-358a-4ed6-acce-152b70976206,37436676,5928,1432,1392,40,37,55
259,58fb0ded-358a-4ed6-acce-152b70976206,37436676,5928,1574,1434,140,38,55
259,58fb0ded-358a-4ed6-acce-152b70976206,37436676,5928,2055,1579,476,40,55
259,58fb0ded-358a-4ed6-acce-152b70976206,37436676,5928,2360,2079,281,41,55
259,58fb0ded-358a-4ed6-acce-152b70976206,37436676,5928,2443,2362,81,52,55
259,58fb0ded-358a-4ed6-acce-152b70976206,37436676,5928,2448,2444,4,53,55
259,58fb0ded-358a-4ed6-acce-152b70976206,37436676,1110,0,0,0,55,55
259,58fb0ded-358a-4ed6-acce-152b70976206,37436946,2364,155,9,146,0,21
259,58fb0ded-358a-4ed6-acce-152b70976206,37436946,2364,296,160,136,1,21
259,58fb0ded-358a-4ed6-acce-152b70976206,37436946,2364,292,104,-188,5,21
259,58fb0ded-358a-4ed6-acce-152b70976206,37436946,2364,266,106,160,6,21
259,58fb0ded-358a-4ed6-acce-152b70976206,37436946,2364,290,265,25,7,21
259,58fb0ded-358a-4ed6-acce-152b70976206,37436946,2364,407,292,115,8,21
259,58fb0ded-358a-4ed6-acce-152b70976206,37436946,2364,592,408,184,9,21
259,58fb0ded-358a-4ed6-acce-152b70976206,37436946,2364,642,598,44,10,21
259,58fb0ded-358a-4ed6-acce-152b70976206,37436946,2364,1008,643,365,11,21
259,58fb0ded-358a-4ed6-acce-152b70976206,37436946,2364,1020,1011,9,17,21
259,58fb0ded-358a-4ed6-acce-152b70976206,37436946,2364,1080,1022,58,18,21
259,58fb0ded-358a-4ed6-acce-152b70976206,37436946,2364,1146,1092,54,19,21
259,58fb0ded-358a-4ed6-acce-152b70976206,37436946,2364,1230,1147,83,20,21
259,58fb0ded-358a-4ed6-acce-152b70976206,37436946,2364,1254,1238,16,21,21
259,58fb0ded-358a-4ed6-acce-152b70976206,37437651,3604,46,4,42,0,22
259,58fb0ded-358a-4ed6-acce-152b70976206,37437651,3604,102,47,55,1,22
259,58fb0ded-358a-4ed6-acce-152b70976206,37437651,3604,115,103,12,2,22
259,58fb0ded-358a-4ed6-acce-152b70976206,37437651,3604,181,116,65,6,22
259,58fb0ded-358a-4ed6-acce-152b70976206,37437651,3604,485,184,301,7,22
259,58fb0ded-358a-4ed6-acce-152b70976206,37437651,3604,647,507,140,8,22
259,58fb0ded-358a-4ed6-acce-152b70976206,37437651,3604,742,668,74,9,22
259,58fb0ded-358a-4ed6-acce-152b70976206,37437651,3604,1475,762,713,10,22
259,58fb0ded-358a-4ed6-acce-152b70976206,37437651,3604,1486,1486,0,18,22
259,58fb0ded-358a-4ed6-acce-152b70976206,37437651,3604,2337,1521,816,19,22
259,58fb0ded-358a-4ed6-acce-152b70976206,37437651,3604,2494,2346,148,22,22
259,c6ac2400-b8c2-4545-ac34-67e6e6e5db13,37451237,3306,17,7,10,0,24
259,c6ac2400-b8c2-4545-ac34-67e6e6e5db13,37451237,3306,140,34,106,1,24
259,c6ac2400-b8c2-4545-ac34-67e6e6e5db13,37451237,3306,151,141,10,2,24
259,c6ac2400-b8c2-4545-ac34-67e6e6e5db13,37451237,3306,193,152,41,3,24
259,c6ac2400-b8c2-4545-ac34-67e6e6e5db13,37451237,3306,203,199,4,4,24
259,c6ac2400-b8c2-4545-ac34-67e6e6e5db13,37451237,3306,242,239,3,5,24
259,c6ac2400-b8c2-4545-ac34-67e6e6e5db13,37451237,3306,313,247,66,6,24
259,c6ac2400-b8c2-4545-ac34-67e6e6e5db13,37451237,3306,444,315,129,7,24
259,c6ac2400-b8c2-4545-ac34-67e6e6e5db13,37451237,3306,643,448,195,8,24
259,c6ac2400-b8c2-4545-ac34-67e6e6e5db13,37451237,3306,859,651,208,9,24
259,c6ac2400-b8c2-4545-ac34-67e6e6e5db13,37451237,3306,1014,860,154,10,24
259,c6ac2400-b8c2-4545-ac34-67e6e6e5db13,37451237,3306,1145,1017,128,12,24
259,c6ac2400-b8c2-4545-ac34-67e6e6e5db13,37451237,3306,1404,1155,249,13,24
259,c6ac2400-b8c2-4545-ac34-67e6e6e5db13,37451237,3306,1410,1402,8,14,24
259,c6ac2400-b8c2-4545-ac34-67e6e6e5db13,37451237,3306,1417,1417,0,18,24
259,c6ac2400-b8c2-4545-ac34-67e6e6e5db13,37451237,3306,1541,1440,101,19,24
259,c6ac2400-b8c2-4545-ac34-67e6e6e5db13,37451237,3306,1678,1543,135,21,24
259,c6ac2400-b8c2-4545-ac34-67e6e6e5db13,37451237,3306,1761,1681,80,22,24
259,c6ac2400-b8c2-4545-ac34-67e6e6e5db13,37451237,3306,1826,1763,63,23,24
259,c6ac2400-b8c2-4545-ac34-67e6e6e5db13,37451237,3306,2196,1840,356,24,24
259,147b53b5-bffe-4cff-9b03-0b051fb32de7,37491982,3406,39,8,31,0,1144
259,147b53b5-bffe-4cff-9b03-0b051fb32de7,37491982,3406,85,38,47,11,1144
259,147b53b5-bffe-4cff-9b03-0b051fb32de7,37491982,3406,166,101,65,12,1144
259,147b53b5-bffe-4cff-9b03-0b051fb32de7,37491982,3406,558,168,390,13,1144
259,147b53b5-bffe-4cff-9b03-0b051fb32de7,37491982,3406,915,571,344,14,1144
259,147b53b5-bffe-4cff-9b03-0b051fb32de7,37491982,3406,1296,934,362,15,1144
259,147b53b5-bffe-4cff-9b03-0b051fb32de7,37491982,3406,1321,1288,-33,16,1144
259,147b53b5-bffe-4cff-9b03-0b051fb32de7,37491982,3406,1287,1264,-23,17,1144
259,147b53b5-bffe-4cff-9b03-0b051fb32de7,37491982,3406,1281,1269,12,20,1144
259,147b53b5-bffe-4cff-9b03-0b051fb32de7,37491982,3406,1286,1285,1,21,1144
259,147b53b5-bffe-4cff-9b03-0b051fb32de7,37491982,3406,1286,1285,-1,21,1144
259,147b53b5-bffe-4cff-9b03-0b051fb32de7,37491982,3406,1580,1389,191,1144,1144
283,29bf6b2c-4106-4b9b-83a9-dcef4edef62c,37537258,3536,125,8,117,0,24
283,29bf6b2c-4106-4b9b-83a9-dcef4edef62c,37537258,3536,151,129,22,1,24
283,29bf6b2c-4106-4b9b-83a9-dcef4edef62c,37537258,3536,491,152,339,2,24
283,29bf6b2c-4106-4b9b-83a9-dcef4edef62c,37537258,3536,717,501,216,3,24
283,29bf6b2c-4106-4b9b-83a9-dcef4edef62c,37537258,3536,946,737,209,4,24
283,29bf6b2c-4106-4b9b-83a9-dcef4edef62c,37537258,3536,1235,960,275,9,24
283,29bf6b2c-4106-4b9b-83a9-dcef4edef62c,37537258,3536,1312,1242,70,10,24
283,29bf6b2c-4106-4b9b-83a9-dcef4edef62c,37537258,3536,1310,1304,-6,13,24
283,29bf6b2c-4106-4b9b-83a9-dcef4edef62c,37537258,3536,1303,1214,-89,17,24
283,29bf6b2c-4106-4b9b-83a9-dcef4edef62c,37537258,3536,1312,1252,60,24,24
298,b2b53d95-02b7-4702-a95f-a26c8f54b620,37548668,9032,137,4,133,0,6
298,b2b53d95-02b7-4702-a95f-a26c8f54b620,37548668,9032,385,150,235,1,6
298,b2b53d95-02b7-4702-a95f-a26c8f54b620,37548668,9032,876,394,482,2,6
298,b2b53d95-02b7-4702-a95f-a26c8f54b620,37548668,9032,1109,883,226,3,6
298,b2b53d95-02b7-4702-a95f-a26c8f54b620,37548668,9032,3613,1118,2495,4,6
298,b2b53d95-02b7-4702-a95f-a26c8f54b620,37548668,9032,6703,3711,2992,5,6
298,b2b53d95-02b7-4702-a95f-a26c8f54b620,37548668,9032,6808,6786,22,6,6
299,c21c569f-6d83-4b82-be73-22cf0a997297,37518681,2974,725,16,709,0,2
299,c21c569f-6d83-4b82-be73-22cf0a997297,37518681,2974,1958,755,1203,1,2
299,c21c569f-6d83-4b82-be73-22cf0a997297,37518681,2974,1943,0,-1943,2,2
301,ea42cbfb-919e-4a66-ad37-f9a40c842fd0,37568540,4563,1,1,0,0,28
301,ea42cbfb-919e-4a66-ad37-f9a40c842fd0,37568540,4563,609,22,587,1,28
301,ea42cbfb-919e-4a66-ad37-f9a40c842fd0,37568540,4563,1027,612,415,2,28
301,ea42cbfb-919e-4a66-ad37-f9a40c842fd0,37568540,4563,978,0,-978,5,28
301,ea42cbfb-919e-4a66-ad37-f9a40c842fd0,37568540,4563,731,29,702,7,28
301,ea42cbfb-919e-4a66-ad37-f9a40c842fd0,37568540,4563,1075,737,338,8,28
301,ea42cbfb-919e-4a66-ad37-f9a40c842fd0,37568540,4563,1417,1079,338,17,28
301,ea42cbfb-919e-4a66-ad37-f9a40c842fd0,37568540,4563,1559,1423,136,18,28
301,ea42cbfb-919e-4a66-ad37-f9a40c842fd0,37568540,4563,1694,1563,131,20,28
301,ea42cbfb-919e-4a66-ad37-f9a40c842fd0,37568540,4563,1867,1697,170,21,28
301,ea42cbfb-919e-4a66-ad37-f9a40c842fd0,37568540,4563,2086,1870,216,22,28
301,ea42cbfb-919e-4a66-ad37-f9a40c842fd0,37568540,4563,2859,2112,747,27,28
301,ea42cbfb-919e-4a66-ad37-f9a40c842fd0,37568540,4563,2884,2865,19,28,28
302,44ccefdc-b913-4c45-b0db-357a13766073,37564020,4933,285,9,276,0,3
302,44ccefdc-b913-4c45-b0db-357a13766073,37564020,4933,2667,291,2376,1,3
302,44ccefdc-b913-4c45-b0db-357a13766073,37564020,4933,2605,0,-2605,3,3
302,44ccefdc-b913-4c45-b0db-357a13766073,37563581,2578,266,13,253,0,1
302,44ccefdc-b913-4c45-b0db-357a13766073,37563581,2578,312,286,26,1,1
303,7e3a884b-f64f-43e4-ad2b-7c3390390841,37571694,3294,194,55,139,0,6
303,7e3a884b-f64f-43e4-ad2b-7c3390390841,37571694,3294,569,221,348,1,6
303,7e3a884b-f64f-43e4-ad2b-7c3390390841,37571694,3294,675,591,84,2,6
303,7e3a884b-f64f-43e4-ad2b-7c3390390841,37571694,3294,1110,701,409,3,6
303,7e3a884b-f64f-43e4-ad2b-7c3390390841,37571694,3294,1116,1110,-6,4,6
303,7e3a884b-f64f-43e4-ad2b-7c3390390841,37571694,3294,1464,1141,323,5,6
303,7e3a884b-f64f-43e4-ad2b-7c3390390841,37571694,3294,1629,1500,129,6,6
303,7e3a884b-f64f-43e4-ad2b-7c3390390841,37568540,4296,372,6,366,0,26
303,7e3a884b-f64f-43e4-ad2b-7c3390390841,37568540,4296,711,400,311,1,26
303,7e3a884b-f64f-43e4-ad2b-7c3390390841,37568540,4296,663,343,-320,4,26
303,7e3a884b-f64f-43e4-ad2b-7c3390390841,37568540,4296,342,341,-1,5,26
303,7e3a884b-f64f-43e4-ad2b-7c3390390841,37568540,4296,313,71,-242,8,26
303,7e3a884b-f64f-43e4-ad2b-7c3390390841,37568540,4296,69,0,-69,9,26
303,7e3a884b-f64f-43e4-ad2b-7c3390390841,37568540,4296,675,29,646,11,26
303,7e3a884b-f64f-43e4-ad2b-7c3390390841,37568540,4296,768,693,75,12,26
303,7e3a884b-f64f-43e4-ad2b-7c3390390841,37568540,4296,1100,804,296,14,26
303,7e3a884b-f64f-43e4-ad2b-7c3390390841,37568540,4296,1282,1108,174,15,26
303,7e3a884b-f64f-43e4-ad2b-7c3390390841,37568540,4296,1547,1289,258,16,26
303,7e3a884b-f64f-43e4-ad2b-7c3390390841,37568540,4296,1907,1563,344,18,26
303,7e3a884b-f64f-43e4-ad2b-7c3390390841,37568540,4296,2110,1920,190,19,26
303,7e3a884b-f64f-43e4-ad2b-7c3390390841,37568540,4296,2202,2114,88,20,26
303,7e3a884b-f64f-43e4-ad2b-7c3390390841,37568540,4296,2259,2204,55,21,26
303,7e3a884b-f64f-43e4-ad2b-7c3390390841,37568540,4296,2276,2270,6,22,26
303,7e3a884b-f64f-43e4-ad2b-7c3390390841,37568540,4296,2631,2281,350,26,26
303,7e3a884b-f64f-43e4-ad2b-7c3390390841,37565653,4074,149,10,139,0,28
303,7e3a884b-f64f-43e4-ad2b-7c3390390841,37565653,4074,295,154,141,1,28
303,7e3a884b-f64f-43e4-ad2b-7c3390390841,37565653,4074,496,336,160,9,28
303,7e3a884b-f64f-43e4-ad2b-7c3390390841,37565653,4074,680,530,150,13,28
303,7e3a884b-f64f-43e4-ad2b-7c3390390841,37565653,4074,1197,702,495,22,28
303,7e3a884b-f64f-43e4-ad2b-7c3390390841,37565653,4074,1426,1227,199,24,28
303,7e3a884b-f64f-43e4-ad2b-7c3390390841,37565653,4074,1922,1459,463,25,28
303,7e3a884b-f64f-43e4-ad2b-7c3390390841,37565653,4074,2088,1946,142,26,28
303,7e3a884b-f64f-43e4-ad2b-7c3390390841,37565653,4074,2409,2115,294,28,28
303,7e3a884b-f64f-43e4-ad2b-7c3390390841,37563250,8061,225,15,210,0,19
303,7e3a884b-f64f-43e4-ad2b-7c3390390841,37563250,8061,334,243,91,1,19
303,7e3a884b-f64f-43e4-ad2b-7c3390390841,37563250,8061,664,339,325,12,19
303,7e3a884b-f64f-43e4-ad2b-7c3390390841,37563250,8061,684,669,15,13,19
303,7e3a884b-f64f-43e4-ad2b-7c3390390841,37563250,8061,1070,708,362,14,19
303,7e3a884b-f64f-43e4-ad2b-7c3390390841,37563250,8061,1270,1095,175,15,19
303,7e3a884b-f64f-43e4-ad2b-7c3390390841,37563250,8061,1852,1311,541,19,19
302,39da56ce-404f-4f58-b226-04d5bc72dc26,37567866,4310,188,4,184,0,12
302,39da56ce-404f-4f58-b226-04d5bc72dc26,37567866,4310,694,240,454,3,12
302,39da56ce-404f-4f58-b226-04d5bc72dc26,37567866,4310,1806,1437,369,6,12
302,39da56ce-404f-4f58-b226-04d5bc72dc26,37567866,4310,2044,1811,233,7,12
302,39da56ce-404f-4f58-b226-04d5bc72dc26,37567866,4310,2044,1395,-649,10,12
302,cad2ddb1-d460-482d-b1fb-6201f3e958fb,37574974,3999,199,5,194,0,11
302,cad2ddb1-d460-482d-b1fb-6201f3e958fb,37574974,3999,355,201,154,1,11
302,cad2ddb1-d460-482d-b1fb-6201f3e958fb,37574974,3999,447,370,77,2,11
302,cad2ddb1-d460-482d-b1fb-6201f3e958fb,37574974,3999,450,448,2,3,11
302,cad2ddb1-d460-482d-b1fb-6201f3e958fb,37574974,3999,679,454,225,4,11
302,cad2ddb1-d460-482d-b1fb-6201f3e958fb,37574974,3999,1082,681,401,5,11
302,cad2ddb1-d460-482d-b1fb-6201f3e958fb,37574974,3999,1251,1090,161,6,11
302,cad2ddb1-d460-482d-b1fb-6201f3e958fb,37574974,3999,1529,1254,275,7,11
302,cad2ddb1-d460-482d-b1fb-6201f3e958fb,37574974,3999,1733,1535,198,8,11
302,cad2ddb1-d460-482d-b1fb-6201f3e958fb,37574974,3999,1733,1132,-601,10,11
302,cad2ddb1-d460-482d-b1fb-6201f3e958fb,37574974,3999,997,0,-997,11,11
302,cad2ddb1-d460-482d-b1fb-6201f3e958fb,37574568,4643,551,24,527,0,8
302,cad2ddb1-d460-482d-b1fb-6201f3e958fb,37574568,4643,555,552,3,1,8
302,cad2ddb1-d460-482d-b1fb-6201f3e958fb,37574568,4643,648,557,91,2,8
302,cad2ddb1-d460-482d-b1fb-6201f3e958fb,37574568,4643,714,649,65,3,8
302,cad2ddb1-d460-482d-b1fb-6201f3e958fb,37574568,4643,843,716,127,4,8
302,cad2ddb1-d460-482d-b1fb-6201f3e958fb,37574568,4643,949,844,105,5,8
302,cad2ddb1-d460-482d-b1fb-6201f3e958fb,37574568,4643,1131,952,179,6,8
302,cad2ddb1-d460-482d-b1fb-6201f3e958fb,37574568,4643,2377,1143,1234,7,8
302,cad2ddb1-d460-482d-b1fb-6201f3e958fb,37574568,4643,2377,2376,1,8,8
304,9d5f18cf-1fb3-4267-9efa-3d59f40e8143,37321656,13440,187,13,174,0,16
304,9d5f18cf-1fb3-4267-9efa-3d59f40e8143,37321656,14252,1181,212,969,1,16
304,9d5f18cf-1fb3-4267-9efa-3d59f40e8143,37321656,14252,1295,1199,96,2,16
304,9d5f18cf-1fb3-4267-9efa-3d59f40e8143,37321656,14252,1579,1530,49,3,16
304,9d5f18cf-1fb3-4267-9efa-3d59f40e8143,37321656,14252,1742,1584,158,9,16
304,9d5f18cf-1fb3-4267-9efa-3d59f40e8143,37321656,14252,2062,1752,310,10,16
304,9d5f18cf-1fb3-4267-9efa-3d59f40e8143,37321656,14252,2099,2063,36,11,16
304,9d5f18cf-1fb3-4267-9efa-3d59f40e8143,37321656,14252,2740,2347,393,16,16
303,126b473e-8f70-4777-bac9-d7459f208708,37582558,2160,224,5,219,0,4
303,126b473e-8f70-4777-bac9-d7459f208708,37582558,2160,384,228,156,1,4
303,126b473e-8f70-4777-bac9-d7459f208708,37582558,2160,387,386,1,2,4
303,126b473e-8f70-4777-bac9-d7459f208708,37582558,2160,495,393,102,3,4
303,126b473e-8f70-4777-bac9-d7459f208708,37582558,2160,495,494,1,4,4
302,e38c3ba4-9954-4dbb-86e8-6424cf2a74c6,37321656,9158,84,1,83,0,26
302,e38c3ba4-9954-4dbb-86e8-6424cf2a74c6,37321656,9158,183,85,98,1,26
302,e38c3ba4-9954-4dbb-86e8-6424cf2a74c6,37321656,9158,366,201,165,6,26
302,e38c3ba4-9954-4dbb-86e8-6424cf2a74c6,37321656,9158,794,414,380,7,26
302,e38c3ba4-9954-4dbb-86e8-6424cf2a74c6,37321656,9158,796,796,0,11,26
302,e38c3ba4-9954-4dbb-86e8-6424cf2a74c6,37321656,9158,875,799,76,12,26
302,e38c3ba4-9954-4dbb-86e8-6424cf2a74c6,37321656,9158,996,879,117,13,26
302,e38c3ba4-9954-4dbb-86e8-6424cf2a74c6,37321656,9158,1065,997,68,15,26
302,e38c3ba4-9954-4dbb-86e8-6424cf2a74c6,37321656,9158,1070,1067,3,16,26
302,e38c3ba4-9954-4dbb-86e8-6424cf2a74c6,37321656,9158,1370,1071,299,19,26
302,e38c3ba4-9954-4dbb-86e8-6424cf2a74c6,37321656,9158,1918,1379,539,20,26
302,e38c3ba4-9954-4dbb-86e8-6424cf2a74c6,37321656,9158,1926,1922,4,21,26
302,e38c3ba4-9954-4dbb-86e8-6424cf2a74c6,37321656,9158,2210,1937,273,22,26
302,e38c3ba4-9954-4dbb-86e8-6424cf2a74c6,37321656,9158,3140,2214,926,23,26
302,e38c3ba4-9954-4dbb-86e8-6424cf2a74c6,37321656,9158,4719,3176,1543,24,26
302,e38c3ba4-9954-4dbb-86e8-6424cf2a74c6,37321656,9158,6598,4720,1878,25,26
302,e38c3ba4-9954-4dbb-86e8-6424cf2a74c6,37321656,9158,6892,6734,158,26,26
302,e38c3ba4-9954-4dbb-86e8-6424cf2a74c6,37573818,4426,3,3,0,0,2
302,e38c3ba4-9954-4dbb-86e8-6424cf2a74c6,37573818,4426,157,6,151,2,2
305,5a0922b8-408e-4965-ab7c-25ad606d29a3,37637453,3184,356,3,353,0,25
305,5a0922b8-408e-4965-ab7c-25ad606d29a3,37637453,3184,546,361,185,1,25
305,5a0922b8-408e-4965-ab7c-25ad606d29a3,37637453,3184,621,552,69,2,25
305,5a0922b8-408e-4965-ab7c-25ad606d29a3,37637453,3184,840,631,209,3,25
305,5a0922b8-408e-4965-ab7c-25ad606d29a3,37637453,3184,931,842,89,4,25
305,5a0922b8-408e-4965-ab7c-25ad606d29a3,37637453,3184,1132,936,196,7,25
305,5a0922b8-408e-4965-ab7c-25ad606d29a3,37637453,3184,1132,1131,1,8,25
305,5a0922b8-408e-4965-ab7c-25ad606d29a3,37637453,3184,1132,1131,-1,8,25
305,5a0922b8-408e-4965-ab7c-25ad606d29a3,37637453,3184,1132,1131,1,9,25
305,5a0922b8-408e-4965-ab7c-25ad606d29a3,37637453,3184,1132,1131,-1,9,25
305,5a0922b8-408e-4965-ab7c-25ad606d29a3,37637453,3184,1132,1131,1,10,25
305,5a0922b8-408e-4965-ab7c-25ad606d29a3,37637453,3184,1132,1131,1,11,25
305,5a0922b8-408e-4965-ab7c-25ad606d29a3,37637453,3184,1132,1131,-1,11,25
305,5a0922b8-408e-4965-ab7c-25ad606d29a3,37637453,3184,1132,1132,0,12,25
305,5a0922b8-408e-4965-ab7c-25ad606d29a3,37637453,3184,1132,1120,-12,13,25
305,5a0922b8-408e-4965-ab7c-25ad606d29a3,37637453,3184,1132,983,149,14,25
305,5a0922b8-408e-4965-ab7c-25ad606d29a3,37637453,3184,1132,1131,1,15,25
305,5a0922b8-408e-4965-ab7c-25ad606d29a3,37637453,3184,1120,0,-1120,25,25
303,ebb6b017-839d-4b36-b9de-841f25f3ab06,37855207,6744,514,10,504,0,40
303,ebb6b017-839d-4b36-b9de-841f25f3ab06,37855207,6744,809,530,279,1,40
303,ebb6b017-839d-4b36-b9de-841f25f3ab06,37855207,6744,1017,819,198,2,40
303,ebb6b017-839d-4b36-b9de-841f25f3ab06,37855207,6744,1173,1060,113,34,40
303,ebb6b017-839d-4b36-b9de-841f25f3ab06,37855207,6744,1951,1196,755,35,40
303,ebb6b017-839d-4b36-b9de-841f25f3ab06,37855207,6744,2106,1960,146,36,40
303,ebb6b017-839d-4b36-b9de-841f25f3ab06,37855207,6744,2262,2111,151,37,40
303,ebb6b017-839d-4b36-b9de-841f25f3ab06,37855207,6744,2406,2273,133,38,40
303,ebb6b017-839d-4b36-b9de-841f25f3ab06,37855207,6744,2587,2414,173,39,40
303,ebb6b017-839d-4b36-b9de-841f25f3ab06,37855207,6744,2605,2590,15,40,40
305,605527d0-a50c-4ce9-b65e-800953575e38,38019771,10072,170,2,168,0,11
305,605527d0-a50c-4ce9-b65e-800953575e38,38019771,10072,332,177,155,1,11
305,605527d0-a50c-4ce9-b65e-800953575e38,38019771,10072,472,339,133,2,11
305,605527d0-a50c-4ce9-b65e-800953575e38,38019771,10072,718,474,244,3,11
305,605527d0-a50c-4ce9-b65e-800953575e38,38019771,10072,1108,725,383,4,11
305,605527d0-a50c-4ce9-b65e-800953575e38,38019771,10072,1525,1139,386,5,11
305,605527d0-a50c-4ce9-b65e-800953575e38,38019771,10072,2136,1542,594,6,11
305,605527d0-a50c-4ce9-b65e-800953575e38,38019771,10072,4673,2186,2487,7,11
305,605527d0-a50c-4ce9-b65e-800953575e38,38019771,10072,8020,4699,3321,8,11
305,605527d0-a50c-4ce9-b65e-800953575e38,38019771,10072,8016,3664,-4352,10,11
305,605527d0-a50c-4ce9-b65e-800953575e38,38019771,10072,3563,1159,-2404,11,11
305,87afaed8-2475-485a-8c72-74d62926a51c,38090977,15544,1146,7,1139,0,9
305,87afaed8-2475-485a-8c72-74d62926a51c,38090977,15544,3241,1149,2092,1,9
305,87afaed8-2475-485a-8c72-74d62926a51c,38090977,15544,7448,3244,4204,2,9
305,87afaed8-2475-485a-8c72-74d62926a51c,38090977,15544,13492,7556,5936,3,9
305,87afaed8-2475-485a-8c72-74d62926a51c,38090977,15544,13439,6101,-7338,6,9
305,87afaed8-2475-485a-8c72-74d62926a51c,38090977,15544,5935,0,-5935,7,9
305,87afaed8-2475-485a-8c72-74d62926a51c,38090977,15544,2765,30,2735,8,9
305,87afaed8-2475-485a-8c72-74d62926a51c,38090977,15544,2315,0,-2315,9,9
310,59045233-b688-41e1-9612-9960261373e5,39136902,8859,834,10,824,0,5
310,59045233-b688-41e1-9612-9960261373e5,39136902,8859,1329,878,451,1,5
310,59045233-b688-41e1-9612-9960261373e5,39136902,8859,1885,1332,553,2,5
310,59045233-b688-41e1-9612-9960261373e5,39136902,8859,3550,1925,1625,3,5
310,59045233-b688-41e1-9612-9960261373e5,39136902,8859,6642,3588,3054,4,5
310,59045233-b688-41e1-9612-9960261373e5,39136902,8859,7191,6707,484,5,5
309,c714781a-17c9-41a5-a1a2-dba4a0ddf40e,39202936,8262,316,2,314,0,92
309,c714781a-17c9-41a5-a1a2-dba4a0ddf40e,39202936,8262,580,334,246,1,92
309,c714781a-17c9-41a5-a1a2-dba4a0ddf40e,39202936,8262,697,581,116,2,92
309,c714781a-17c9-41a5-a1a2-dba4a0ddf40e,39202936,8262,1220,711,509,23,92
309,c714781a-17c9-41a5-a1a2-dba4a0ddf40e,39202936,8262,1440,1238,202,24,92
309,c714781a-17c9-41a5-a1a2-dba4a0ddf40e,39202936,8262,1456,1443,13,25,92
309,c714781a-17c9-41a5-a1a2-dba4a0ddf40e,39202936,8262,1800,1458,342,47,92
309,c714781a-17c9-41a5-a1a2-dba4a0ddf40e,39202936,8262,1962,1806,156,48,92
309,c714781a-17c9-41a5-a1a2-dba4a0ddf40e,39202936,8262,2359,1987,372,73,92
309,c714781a-17c9-41a5-a1a2-dba4a0ddf40e,39202936,8262,2507,2375,132,74,92
309,c714781a-17c9-41a5-a1a2-dba4a0ddf40e,39202936,8262,3322,2520,802,78,92
309,c714781a-17c9-41a5-a1a2-dba4a0ddf40e,39202936,8262,3596,3331,265,89,92
309,c714781a-17c9-41a5-a1a2-dba4a0ddf40e,39202936,8262,3653,3597,56,90,92
309,c714781a-17c9-41a5-a1a2-dba4a0ddf40e,39202936,8262,3845,3658,187,91,92
309,c714781a-17c9-41a5-a1a2-dba4a0ddf40e,39202936,8262,3983,3847,136,92,92
328,de2f2a02-62b7-4346-b92a-13b00ce79e23,40247178,8224,974,49,925,0,19
328,de2f2a02-62b7-4346-b92a-13b00ce79e23,40247178,8224,1410,998,412,1,19
328,de2f2a02-62b7-4346-b92a-13b00ce79e23,40247178,8224,1538,1254,284,2,19
328,de2f2a02-62b7-4346-b92a-13b00ce79e23,40247178,8224,1534,1393,-141,3,19
328,de2f2a02-62b7-4346-b92a-13b00ce79e23,40247178,8224,1978,1374,604,4,19
328,de2f2a02-62b7-4346-b92a-13b00ce79e23,40247178,8224,2172,1980,192,5,19
328,de2f2a02-62b7-4346-b92a-13b00ce79e23,40247178,8224,2720,2109,611,6,19
328,de2f2a02-62b7-4346-b92a-13b00ce79e23,40247178,8224,3484,2738,746,7,19
328,de2f2a02-62b7-4346-b92a-13b00ce79e23,40247178,8224,3650,3504,146,8,19
328,de2f2a02-62b7-4346-b92a-13b00ce79e23,40247178,8224,3822,3660,162,9,19
328,de2f2a02-62b7-4346-b92a-13b00ce79e23,40247178,8224,3975,3840,135,10,19
328,de2f2a02-62b7-4346-b92a-13b00ce79e23,40247178,8224,4111,3982,129,11,19
328,de2f2a02-62b7-4346-b92a-13b00ce79e23,40247178,8224,4466,4132,334,12,19
328,de2f2a02-62b7-4346-b92a-13b00ce79e23,40247178,8224,4552,4474,78,13,19
328,de2f2a02-62b7-4346-b92a-13b00ce79e23,40247178,8224,4804,4576,228,14,19
328,de2f2a02-62b7-4346-b92a-13b00ce79e23,40247178,8224,5002,4807,195,15,19
328,de2f2a02-62b7-4346-b92a-13b00ce79e23,40247178,8224,5644,5030,614,16,19
328,de2f2a02-62b7-4346-b92a-13b00ce79e23,40247178,8224,6000,5659,341,17,19
328,de2f2a02-62b7-4346-b92a-13b00ce79e23,40247178,8224,5916,0,-5916,19,19
8,327fb42c-9ce8-45d1-bdb3-32b8f8458390,40391395,13375,245,20,225,0,7
8,327fb42c-9ce8-45d1-bdb3-32b8f8458390,40391395,13375,414,246,168,1,7
8,327fb42c-9ce8-45d1-bdb3-32b8f8458390,40391395,13375,1165,439,726,2,7
8,327fb42c-9ce8-45d1-bdb3-32b8f8458390,40391395,13375,2651,1179,1472,3,7
8,327fb42c-9ce8-45d1-bdb3-32b8f8458390,40391395,13375,4373,2713,1660,4,7
8,327fb42c-9ce8-45d1-bdb3-32b8f8458390,40391395,13375,4888,2270,-2618,5,7
8,327fb42c-9ce8-45d1-bdb3-32b8f8458390,40391395,13375,2171,150,-2021,6,7
8,327fb42c-9ce8-45d1-bdb3-32b8f8458390,40391395,13375,147,142,-5,7,7
8,7052adfb-743a-4b48-90cd-6f94aa6aa2b9,40391395,15100,309,23,286,0,4
8,7052adfb-743a-4b48-90cd-6f94aa6aa2b9,40391395,15100,791,318,473,1,4
8,7052adfb-743a-4b48-90cd-6f94aa6aa2b9,40391395,15100,1331,807,524,2,4
8,7052adfb-743a-4b48-90cd-6f94aa6aa2b9,40391395,15100,2330,1336,994,3,4
8,7052adfb-743a-4b48-90cd-6f94aa6aa2b9,40391395,15100,3460,2331,1129,4,4
8,7dd19b11-cb33-4564-b768-d1ce2ad83418,40390642,3227,499,2,497,0,0
8,79a919ed-c280-4472-90fe-30f3d1971436,40391395,15100,2230,14,2216,0,3
8,79a919ed-c280-4472-90fe-30f3d1971436,40391395,15100,3117,2238,879,1,3
8,79a919ed-c280-4472-90fe-30f3d1971436,40391395,15100,3455,2895,-560,2,3
8,79a919ed-c280-4472-90fe-30f3d1971436,40391395,15100,2856,1759,-1097,3,3
8,79a919ed-c280-4472-90fe-30f3d1971436,40383981,3151,959,44,915,0,2
8,79a919ed-c280-4472-90fe-30f3d1971436,40383981,3151,1455,1009,446,1,2
8,79a919ed-c280-4472-90fe-30f3d1971436,40383981,3151,1578,1456,122,2,2
8,c6960ed9-ef5d-4e27-92d3-18e6c5215a96,40385651,2965,1392,20,1372,0,0
8,8f3e65dd-36fa-49c6-a90c-68f2a757b324,40381233,2148,575,3,572,0,2
8,8f3e65dd-36fa-49c6-a90c-68f2a757b324,40381233,2148,565,42,-523,2,2
8,8f3e65dd-36fa-49c6-a90c-68f2a757b324,40391395,15100,708,3,705,0,1
8,8f3e65dd-36fa-49c6-a90c-68f2a757b324,40391395,15100,1026,722,304,1,1
8,a4eeb057-1868-4df5-aee8-6296766ead05,40390642,3227,1654,11,1643,0,0
8,a7edf6d2-ba79-45dd-8b3c-6d1cfad1f4b8,40383981,3760,326,28,298,0,4
8,a7edf6d2-ba79-45dd-8b3c-6d1cfad1f4b8,40383981,3760,1843,390,1453,1,4
8,a7edf6d2-ba79-45dd-8b3c-6d1cfad1f4b8,40383981,3760,1850,1845,5,2,4
8,a7edf6d2-ba79-45dd-8b3c-6d1cfad1f4b8,40383981,3760,2007,1861,146,4,4
8,9a8b2d9a-638a-4d86-bc2c-559ad3650265,40391819,2314,21,21,0,0,2
8,9a8b2d9a-638a-4d86-bc2c-559ad3650265,40391819,2314,741,102,639,1,2
8,9a8b2d9a-638a-4d86-bc2c-559ad3650265,40391819,2314,390,0,-390,2,2
8,f32a40e1-b781-4ed8-acb9-831bedb8f6da,40378913,8816,273,19,254,0,1
8,f32a40e1-b781-4ed8-acb9-831bedb8f6da,40378913,8816,921,307,614,1,1
8,291623bb-aa8c-4e73-9ef2-7166e4c21727,40383699,3356,1528,29,1499,0,1
8,291623bb-aa8c-4e73-9ef2-7166e4c21727,40383699,3356,1605,1538,67,1,1
8,1cde80b1-5e88-4623-9425-2408c3fcc824,40386827,3589,966,13,953,0,1
8,1cde80b1-5e88-4623-9425-2408c3fcc824,40386827,3589,1100,43,-1057,1,1
8,47325e14-0027-4e99-a75f-14586fed575e,40391764,2742,802,19,783,0,1
8,47325e14-0027-4e99-a75f-14586fed575e,40391764,2742,1169,836,333,1,1
8,7c15687e-ee5c-4356-8bbf-2138e5312328,40391221,4891,667,8,659,0,3
8,7c15687e-ee5c-4356-8bbf-2138e5312328,40391221,4891,923,673,250,1,3
8,7c15687e-ee5c-4356-8bbf-2138e5312328,40391221,4891,3189,931,2258,2,3
8,7c15687e-ee5c-4356-8bbf-2138e5312328,40391221,4891,2036,1575,-461,3,3
8,58f8eade-43db-4214-af33-37d5bde9d491,40036526,4351,108,5,103,0,3
8,58f8eade-43db-4214-af33-37d5bde9d491,40036526,4351,602,129,473,1,3
8,58f8eade-43db-4214-af33-37d5bde9d491,40036526,4351,835,310,-525,2,3
8,58f8eade-43db-4214-af33-37d5bde9d491,40036526,4351,308,249,-59,3,3
8,bcff33bc-adc7-4c35-a50d-172bf3720c78,40382877,4288,817,17,800,0,2
8,bcff33bc-adc7-4c35-a50d-172bf3720c78,40382877,4288,1649,448,-1201,1,2
8,bcff33bc-adc7-4c35-a50d-172bf3720c78,40382877,4288,386,5,-381,2,2
8,dfc8951c-6abe-480b-aebd-a3b53c6baed2,40380403,4107,252,16,236,0,3
8,dfc8951c-6abe-480b-aebd-a3b53c6baed2,40380403,4107,698,254,444,1,3
8,dfc8951c-6abe-480b-aebd-a3b53c6baed2,40380403,4107,946,693,-253,2,3
8,dfc8951c-6abe-480b-aebd-a3b53c6baed2,40380403,4107,680,590,-90,3,3
8,a4eec59b-ff6b-48c7-9622-e680d8dfb42b,40391764,2742,234,10,224,0,0
8,8ea30ae1-7881-4b95-aec7-400bc984ecac,40380403,4107,313,11,302,0,2
8,8ea30ae1-7881-4b95-aec7-400bc984ecac,40380403,4107,1457,316,1141,1,2
8,8ea30ae1-7881-4b95-aec7-400bc984ecac,40380403,4107,1709,1383,-326,2,2
8,b4020d5b-bb70-4423-a2c6-cb21454f3d22,40354990,4306,204,3,201,0,2
8,b4020d5b-bb70-4423-a2c6-cb21454f3d22,40354990,4306,518,221,297,1,2
8,b4020d5b-bb70-4423-a2c6-cb21454f3d22,40354990,4306,511,6,-505,2,2
8,694be98e-155a-4a84-8e3d-0771c17c274d,40409981,6737,410,123,287,0,2
8,694be98e-155a-4a84-8e3d-0771c17c274d,40409981,6737,1241,465,776,1,2
8,694be98e-155a-4a84-8e3d-0771c17c274d,40409981,6737,887,418,-469,2,2
8,694be98e-155a-4a84-8e3d-0771c17c274d,40409490,8960,611,13,598,0,2
8,694be98e-155a-4a84-8e3d-0771c17c274d,40409490,8960,3901,619,3282,1,2
8,694be98e-155a-4a84-8e3d-0771c17c274d,40409490,8960,3855,2109,-1746,2,2
8,8d6ad5cf-0613-4d37-a590-e2309f133bba,40405576,4768,147,18,129,0,3
8,8d6ad5cf-0613-4d37-a590-e2309f133bba,40405576,4768,1277,152,1125,1,3
8,8d6ad5cf-0613-4d37-a590-e2309f133bba,40405576,4768,1815,1286,529,2,3
8,8d6ad5cf-0613-4d37-a590-e2309f133bba,40405576,4768,1819,1816,3,3,3
8,21932d4b-f4e6-4bc2-9a26-cccdf0473c17,40453054,9593,243,23,220,0,18
8,21932d4b-f4e6-4bc2-9a26-cccdf0473c17,40453054,9593,410,249,161,1,18
8,21932d4b-f4e6-4bc2-9a26-cccdf0473c17,40453054,9593,526,421,105,2,18
8,21932d4b-f4e6-4bc2-9a26-cccdf0473c17,40453054,9593,659,558,101,3,18
8,21932d4b-f4e6-4bc2-9a26-cccdf0473c17,40453054,9593,898,681,217,4,18
8,21932d4b-f4e6-4bc2-9a26-cccdf0473c17,40453054,9593,1069,903,166,5,18
8,21932d4b-f4e6-4bc2-9a26-cccdf0473c17,40453054,9593,1319,1094,225,6,18
8,21932d4b-f4e6-4bc2-9a26-cccdf0473c17,40453054,9593,1539,1327,212,7,18
8,21932d4b-f4e6-4bc2-9a26-cccdf0473c17,40453054,9593,1746,1540,206,8,18
8,21932d4b-f4e6-4bc2-9a26-cccdf0473c17,40453054,9593,1936,1762,174,9,18
8,21932d4b-f4e6-4bc2-9a26-cccdf0473c17,40453054,9593,2187,1944,243,10,18
8,21932d4b-f4e6-4bc2-9a26-cccdf0473c17,40453054,9593,2437,2210,227,11,18
8,21932d4b-f4e6-4bc2-9a26-cccdf0473c17,40453054,9593,2522,2438,84,12,18
8,21932d4b-f4e6-4bc2-9a26-cccdf0473c17,40453054,9593,2611,2526,85,13,18
8,21932d4b-f4e6-4bc2-9a26-cccdf0473c17,40453054,9593,2857,2613,244,14,18
8,21932d4b-f4e6-4bc2-9a26-cccdf0473c17,40453054,9593,3160,2860,300,15,18
8,21932d4b-f4e6-4bc2-9a26-cccdf0473c17,40453054,9593,3501,3169,332,16,18
8,21932d4b-f4e6-4bc2-9a26-cccdf0473c17,40453054,9593,3512,3505,7,17,18
8,21932d4b-f4e6-4bc2-9a26-cccdf0473c17,40453054,9593,3802,3670,132,18,18
8,a868b226-d893-4f04-a782-8e940236e839,40452360,9299,204,46,158,0,9
8,a868b226-d893-4f04-a782-8e940236e839,40452360,9299,504,216,288,1,9
8,a868b226-d893-4f04-a782-8e940236e839,40452360,9299,818,523,295,2,9
8,a868b226-d893-4f04-a782-8e940236e839,40452360,9299,1162,833,329,3,9
8,a868b226-d893-4f04-a782-8e940236e839,40452360,9299,1453,1165,288,4,9
8,a868b226-d893-4f04-a782-8e940236e839,40452360,9299,1982,1479,503,5,9
8,a868b226-d893-4f04-a782-8e940236e839,40452360,9299,2313,1985,328,6,9
8,a868b226-d893-4f04-a782-8e940236e839,40452360,9299,2694,2337,357,7,9
8,a868b226-d893-4f04-a782-8e940236e839,40452360,9299,2697,2105,-592,8,9
8,a868b226-d893-4f04-a782-8e940236e839,40452360,9299,2090,1783,-307,9,9
357,f6011a98-9911-4e35-8ad4-aa2e6e56daff,40590000,3660,0,0,0,0,6
357,f6011a98-9911-4e35-8ad4-aa2e6e56daff,40590000,3660,0,0,0,1,6
357,f6011a98-9911-4e35-8ad4-aa2e6e56daff,40590000,3660,1512,4,1508,2,6
357,f6011a98-9911-4e35-8ad4-aa2e6e56daff,40590000,3660,1992,1553,439,3,6
357,f6011a98-9911-4e35-8ad4-aa2e6e56daff,40590000,3660,1935,1482,-453,4,6
357,f6011a98-9911-4e35-8ad4-aa2e6e56daff,40590000,3660,1439,77,-1362,5,6
357,f6011a98-9911-4e35-8ad4-aa2e6e56daff,40590000,3660,56,0,-56,6,6
364,205d605e-7b4a-4e70-9aba-e136f92a4c87,40597244,7623,469,13,456,0,4
364,205d605e-7b4a-4e70-9aba-e136f92a4c87,40597244,7623,546,480,66,1,4
364,205d605e-7b4a-4e70-9aba-e136f92a4c87,40597244,7623,548,548,0,2,4
364,205d605e-7b4a-4e70-9aba-e136f92a4c87,40597244,7623,1354,569,785,3,4
364,205d605e-7b4a-4e70-9aba-e136f92a4c87,40597244,7623,1619,1356,263,4,4
8,5f5be5e8-f39a-413c-91a8-ed7643335735,40589510,9601,119,8,111,0,6
8,5f5be5e8-f39a-413c-91a8-ed7643335735,40589510,9601,1365,121,1244,1,6
8,5f5be5e8-f39a-413c-91a8-ed7643335735,40589510,9601,1374,1368,6,2,6
8,5f5be5e8-f39a-413c-91a8-ed7643335735,40589510,9601,1582,1377,205,3,6
8,5f5be5e8-f39a-413c-91a8-ed7643335735,40589510,9601,1758,1596,162,4,6
8,5f5be5e8-f39a-413c-91a8-ed7643335735,40589510,9601,2199,1761,438,5,6
8,5f5be5e8-f39a-413c-91a8-ed7643335735,40589510,9601,2476,2218,258,6,6
8,5f5be5e8-f39a-413c-91a8-ed7643335735,40597514,10714,430,12,418,0,2
8,5f5be5e8-f39a-413c-91a8-ed7643335735,40597514,10714,1326,456,870,1,2
8,5f5be5e8-f39a-413c-91a8-ed7643335735,40597514,10714,1481,1345,136,2,2
8,b9dde3b2-9db8-4a70-945a-3e20ca02b8cc,40597244,6123,34,34,0,0,4
8,b9dde3b2-9db8-4a70-945a-3e20ca02b8cc,40597244,6123,683,74,609,1,4
8,b9dde3b2-9db8-4a70-945a-3e20ca02b8cc,40597244,6123,1442,700,742,2,4
8,b9dde3b2-9db8-4a70-945a-3e20ca02b8cc,40597244,6123,1823,1456,367,3,4
8,b9dde3b2-9db8-4a70-945a-3e20ca02b8cc,40597244,6123,2108,1829,279,4,4
8,c3808643-5509-4b23-91ac-caf572ed10a5,40598483,4923,1988,4,1984,0,1
8,c3808643-5509-4b23-91ac-caf572ed10a5,40598483,4923,2117,2001,116,1,1
8,0d1f8447-916e-43b1-9689-e4f53545f430,40593286,8141,3738,8,3730,0,1
8,0d1f8447-916e-43b1-9689-e4f53545f430,40593286,8141,3988,3791,197,1,1
356,8681e5c0-d575-4397-87f4-1a4558829985,40598015,5800,1513,20,1493,0,27
356,8681e5c0-d575-4397-87f4-1a4558829985,40598015,5800,1826,1539,287,1,27
356,8681e5c0-d575-4397-87f4-1a4558829985,40598015,5800,1626,1464,-162,2,27
356,8681e5c0-d575-4397-87f4-1a4558829985,40598015,5800,1462,1331,-131,4,27
356,8681e5c0-d575-4397-87f4-1a4558829985,40598015,5800,1330,1328,-2,5,27
356,8681e5c0-d575-4397-87f4-1a4558829985,40598015,5800,1313,1128,-185,7,27
356,8681e5c0-d575-4397-87f4-1a4558829985,40598015,5800,1125,1122,-3,8,27
356,8681e5c0-d575-4397-87f4-1a4558829985,40598015,5800,1113,30,-1083,11,27
356,8681e5c0-d575-4397-87f4-1a4558829985,40598015,5800,0,0,0,12,27
356,8681e5c0-d575-4397-87f4-1a4558829985,40598015,5800,111,14,97,17,27
356,8681e5c0-d575-4397-87f4-1a4558829985,40598015,5800,382,113,269,19,27
356,8681e5c0-d575-4397-87f4-1a4558829985,40598015,5800,547,400,147,24,27
356,8681e5c0-d575-4397-87f4-1a4558829985,40598015,5800,940,562,378,25,27
356,8681e5c0-d575-4397-87f4-1a4558829985,40598015,5800,963,944,19,26,27
356,8681e5c0-d575-4397-87f4-1a4558829985,40598015,5800,1343,967,376,27,27
356,8681e5c0-d575-4397-87f4-1a4558829985,40598351,2689,304,8,296,0,3
356,8681e5c0-d575-4397-87f4-1a4558829985,40598351,2689,780,314,466,1,3
356,8681e5c0-d575-4397-87f4-1a4558829985,40598351,2689,819,787,32,2,3
356,8681e5c0-d575-4397-87f4-1a4558829985,40598351,2689,933,828,105,3,3
328,079ae5a6-95ec-4baf-b18e-2edc010658bc,40608002,6604,632,47,585,0,9
328,079ae5a6-95ec-4baf-b18e-2edc010658bc,40608002,6604,820,637,183,1,9
328,079ae5a6-95ec-4baf-b18e-2edc010658bc,40608002,6604,962,830,132,2,9
328,079ae5a6-95ec-4baf-b18e-2edc010658bc,40608002,6604,1507,1009,498,3,9
328,079ae5a6-95ec-4baf-b18e-2edc010658bc,40608002,6604,1904,1529,375,4,9
328,079ae5a6-95ec-4baf-b18e-2edc010658bc,40608002,6604,2123,1911,212,5,9
328,079ae5a6-95ec-4baf-b18e-2edc010658bc,40608002,6604,2303,2136,167,6,9
328,079ae5a6-95ec-4baf-b18e-2edc010658bc,40608002,6604,2612,2305,307,7,9
328,079ae5a6-95ec-4baf-b18e-2edc010658bc,40608002,6604,2951,2641,310,8,9
328,079ae5a6-95ec-4baf-b18e-2edc010658bc,40608002,6604,4380,3001,1379,9,9
328,079ae5a6-95ec-4baf-b18e-2edc010658bc,40610167,10416,305,11,294,0,26
328,079ae5a6-95ec-4baf-b18e-2edc010658bc,40610167,10416,662,313,349,1,26
328,079ae5a6-95ec-4baf-b18e-2edc010658bc,40610167,10416,875,671,204,2,26
328,079ae5a6-95ec-4baf-b18e-2edc010658bc,40610167,10416,1117,876,241,3,26
328,079ae5a6-95ec-4baf-b18e-2edc010658bc,40610167,10416,1239,1126,113,5,26
328,079ae5a6-95ec-4baf-b18e-2edc010658bc,40610167,10416,1350,1256,94,7,26
328,079ae5a6-95ec-4baf-b18e-2edc010658bc,40610167,10416,1486,1359,127,8,26
328,079ae5a6-95ec-4baf-b18e-2edc010658bc,40610167,10416,1714,1488,226,9,26
328,079ae5a6-95ec-4baf-b18e-2edc010658bc,40610167,10416,1892,1727,165,10,26
328,079ae5a6-95ec-4baf-b18e-2edc010658bc,40610167,10416,1812,0,-1812,19,26
328,079ae5a6-95ec-4baf-b18e-2edc010658bc,40610167,10416,2497,85,2412,20,26
328,079ae5a6-95ec-4baf-b18e-2edc010658bc,40610167,10416,4476,0,-4476,21,26
328,079ae5a6-95ec-4baf-b18e-2edc010658bc,40610167,10416,167,35,132,22,26
328,079ae5a6-95ec-4baf-b18e-2edc010658bc,40610167,10416,142,20,-122,23,26
328,079ae5a6-95ec-4baf-b18e-2edc010658bc,40610167,10416,5925,113,5812,24,26
328,079ae5a6-95ec-4baf-b18e-2edc010658bc,40610167,10416,8192,6015,2177,25,26
328,079ae5a6-95ec-4baf-b18e-2edc010658bc,40610167,10416,8137,6011,-2126,26,26
364,39929020-e031-4b4b-b8b6-4a29dd2f3e24,40606244,3237,83,2,81,0,34
364,39929020-e031-4b4b-b8b6-4a29dd2f3e24,40606244,3237,436,102,334,2,34
364,39929020-e031-4b4b-b8b6-4a29dd2f3e24,40606244,3237,528,439,89,3,34
364,39929020-e031-4b4b-b8b6-4a29dd2f3e24,40606244,3237,692,537,155,4,34
364,39929020-e031-4b4b-b8b6-4a29dd2f3e24,40606244,3237,779,694,85,5,34
364,39929020-e031-4b4b-b8b6-4a29dd2f3e24,40606244,3237,841,780,61,6,34
364,39929020-e031-4b4b-b8b6-4a29dd2f3e24,40606244,3237,930,843,87,8,34
364,39929020-e031-4b4b-b8b6-4a29dd2f3e24,40606244,3237,1021,935,86,9,34
364,39929020-e031-4b4b-b8b6-4a29dd2f3e24,40606244,3237,1090,1022,68,10,34
364,39929020-e031-4b4b-b8b6-4a29dd2f3e24,40606244,3237,1137,1091,46,11,34
364,39929020-e031-4b4b-b8b6-4a29dd2f3e24,40606244,3237,1214,1138,76,12,34
364,39929020-e031-4b4b-b8b6-4a29dd2f3e24,40606244,3237,1271,1221,50,13,34
364,39929020-e031-4b4b-b8b6-4a29dd2f3e24,40606244,3237,1332,1273,59,14,34
364,39929020-e031-4b4b-b8b6-4a29dd2f3e24,40606244,3237,1385,1337,48,15,34
364,39929020-e031-4b4b-b8b6-4a29dd2f3e24,40606244,3237,1421,1388,33,18,34
364,39929020-e031-4b4b-b8b6-4a29dd2f3e24,40606244,3237,1491,1427,64,19,34
364,39929020-e031-4b4b-b8b6-4a29dd2f3e24,40606244,3237,1569,1504,65,21,34
364,39929020-e031-4b4b-b8b6-4a29dd2f3e24,40606244,3237,1519,470,-1049,27,34
364,39929020-e031-4b4b-b8b6-4a29dd2f3e24,40606244,3237,421,0,-421,28,34
364,39929020-e031-4b4b-b8b6-4a29dd2f3e24,40606244,3237,20,0,-20,34,34
364,39929020-e031-4b4b-b8b6-4a29dd2f3e24,40604732,5688,82,14,68,0,10
364,39929020-e031-4b4b-b8b6-4a29dd2f3e24,40604732,5688,85,83,2,1,10
364,39929020-e031-4b4b-b8b6-4a29dd2f3e24,40604732,5688,256,91,165,2,10
364,39929020-e031-4b4b-b8b6-4a29dd2f3e24,40604732,5688,257,257,0,3,10
364,39929020-e031-4b4b-b8b6-4a29dd2f3e24,40604732,5688,251,129,-122,4,10
364,39929020-e031-4b4b-b8b6-4a29dd2f3e24,40604732,5688,2661,145,2516,7,10
364,39929020-e031-4b4b-b8b6-4a29dd2f3e24,40604732,5688,3876,2717,1159,8,10
364,39929020-e031-4b4b-b8b6-4a29dd2f3e24,40604732,5688,4020,3917,103,9,10
364,39929020-e031-4b4b-b8b6-4a29dd2f3e24,40604732,5688,3952,2914,-1038,10,10
364,39929020-e031-4b4b-b8b6-4a29dd2f3e24,40582046,12165,272,17,255,0,2
364,39929020-e031-4b4b-b8b6-4a29dd2f3e24,40582046,12165,1240,283,957,1,2
364,39929020-e031-4b4b-b8b6-4a29dd2f3e24,40582046,12165,1960,1309,651,2,2
356,afa8f904-bfa9-40bb-8c0a-d26c75d5caa7,40609989,2265,354,7,347,0,54
356,afa8f904-bfa9-40bb-8c0a-d26c75d5caa7,40609989,2265,393,393,0,1,54
356,afa8f904-bfa9-40bb-8c0a-d26c75d5caa7,40609989,2265,441,402,39,54,54
356,57425a68-c99b-4a0d-ac2e-8c67f4e83616,40622173,2028,204,24,180,0,0
356,57425a68-c99b-4a0d-ac2e-8c67f4e83616,40622623,3291,668,8,660,0,0
376,533adaa5-a776-4a32-80fc-847c19d11d49,40635443,8124,1062,8,1054,0,58
376,533adaa5-a776-4a32-80fc-847c19d11d49,40635443,8124,1241,1071,170,1,58
376,533adaa5-a776-4a32-80fc-847c19d11d49,40635443,8124,1419,1246,173,2,58
376,533adaa5-a776-4a32-80fc-847c19d11d49,40635443,8124,1476,1421,55,3,58
376,533adaa5-a776-4a32-80fc-847c19d11d49,40635443,8124,2468,1477,991,4,58
376,533adaa5-a776-4a32-80fc-847c19d11d49,40635443,8124,2769,2477,292,5,58
376,533adaa5-a776-4a32-80fc-847c19d11d49,40635443,8124,2765,2738,-27,58,58
356,d1b377c9-8172-4bc6-9102-0b4ff53ee1e1,40642701,13908,832,21,811,0,11
356,d1b377c9-8172-4bc6-9102-0b4ff53ee1e1,40642701,13908,3284,913,2371,2,11
356,d1b377c9-8172-4bc6-9102-0b4ff53ee1e1,40642701,13908,3979,2200,-1779,3,11
356,d1b377c9-8172-4bc6-9102-0b4ff53ee1e1,40642701,13908,2184,2090,-94,4,11
356,d1b377c9-8172-4bc6-9102-0b4ff53ee1e1,40642701,13908,3907,2091,1816,10,11
356,d1b377c9-8172-4bc6-9102-0b4ff53ee1e1,40642701,13908,5064,3977,1087,11,11
356,d1b377c9-8172-4bc6-9102-0b4ff53ee1e1,40652803,4077,515,13,502,0,11
356,d1b377c9-8172-4bc6-9102-0b4ff53ee1e1,40652803,4077,1121,540,581,4,11
356,d1b377c9-8172-4bc6-9102-0b4ff53ee1e1,40652803,4077,1175,1128,47,5,11
356,d1b377c9-8172-4bc6-9102-0b4ff53ee1e1,40652803,4077,2253,1194,1059,6,11
356,d1b377c9-8172-4bc6-9102-0b4ff53ee1e1,40652803,1824,0,0,0,11,11
356,87ccb1cb-2cd2-4538-9b5d-e417c83b6c64,40669333,2655,78,36,42,0,1
356,87ccb1cb-2cd2-4538-9b5d-e417c83b6c64,40669333,2655,831,122,709,1,1
356,bdebfad9-d621-4c91-9eab-1b0284e876c5,40673053,2751,529,18,511,0,2
356,bdebfad9-d621-4c91-9eab-1b0284e876c5,40673053,2751,658,543,115,1,2
356,bdebfad9-d621-4c91-9eab-1b0284e876c5,40673053,2751,783,664,119,2,2
356,bdebfad9-d621-4c91-9eab-1b0284e876c5,40673919,7167,173,3,170,0,5
356,bdebfad9-d621-4c91-9eab-1b0284e876c5,40673919,7167,400,182,218,1,5
356,bdebfad9-d621-4c91-9eab-1b0284e876c5,40673919,7167,622,402,220,2,5
356,bdebfad9-d621-4c91-9eab-1b0284e876c5,40673919,7167,753,633,120,5,5
364,6bfb2dd7-9820-42c7-b82a-537de2172e0e,40667089,6702,156,19,137,0,47
364,6bfb2dd7-9820-42c7-b82a-537de2172e0e,40667089,6702,363,166,197,1,47
364,6bfb2dd7-9820-42c7-b82a-537de2172e0e,40667089,6702,438,376,62,2,47
364,6bfb2dd7-9820-42c7-b82a-537de2172e0e,40667089,6702,585,448,137,3,47
364,6bfb2dd7-9820-42c7-b82a-537de2172e0e,40667089,6702,669,588,81,4,47
364,6bfb2dd7-9820-42c7-b82a-537de2172e0e,40667089,6702,720,682,38,5,47
364,6bfb2dd7-9820-42c7-b82a-537de2172e0e,40667089,6702,772,729,43,6,47
364,6bfb2dd7-9820-42c7-b82a-537de2172e0e,40667089,6702,806,775,31,7,47
364,6bfb2dd7-9820-42c7-b82a-537de2172e0e,40667089,6702,867,810,57,8,47
364,6bfb2dd7-9820-42c7-b82a-537de2172e0e,40667089,6702,874,869,5,9,47
364,6bfb2dd7-9820-42c7-b82a-537de2172e0e,40667089,6702,1867,895,972,34,47
364,6bfb2dd7-9820-42c7-b82a-537de2172e0e,40667089,6702,2154,1887,267,35,47
364,6bfb2dd7-9820-42c7-b82a-537de2172e0e,40667089,6702,2274,2159,115,36,47
364,6bfb2dd7-9820-42c7-b82a-537de2172e0e,40667089,6702,2321,2277,44,37,47
364,6bfb2dd7-9820-42c7-b82a-537de2172e0e,40667089,6702,2507,2324,183,38,47
364,6bfb2dd7-9820-42c7-b82a-537de2172e0e,40667089,6702,2711,2520,191,39,47
364,6bfb2dd7-9820-42c7-b82a-537de2172e0e,40667089,6702,2794,2717,77,40,47
364,6bfb2dd7-9820-42c7-b82a-537de2172e0e,40667089,6702,4208,2839,1369,43,47
364,6bfb2dd7-9820-42c7-b82a-537de2172e0e,40667089,6702,4673,4214,459,44,47
364,6bfb2dd7-9820-42c7-b82a-537de2172e0e,40667089,6702,5034,4728,306,45,47
364,6bfb2dd7-9820-42c7-b82a-537de2172e0e,40667089,6702,5033,5031,-2,46,47
364,6bfb2dd7-9820-42c7-b82a-537de2172e0e,40667089,6702,4790,2841,-1949,47,47
356,d8eb47e2-856a-4290-8431-37f949b43469,40708853,8607,437,24,413,0,17
356,d8eb47e2-856a-4290-8431-37f949b43469,40708853,8607,1362,446,916,14,17
356,d8eb47e2-856a-4290-8431-37f949b43469,40708853,8607,1543,1369,174,15,17
356,d8eb47e2-856a-4290-8431-37f949b43469,40708853,8607,4062,1612,2450,16,17
356,d8eb47e2-856a-4290-8431-37f949b43469,40708853,8607,4063,4063,0,17,17
356,f61a3bda-822d-41d1-ba70-368cca418dc5,40051032,2409,585,13,572,0,0
356,471723a2-98ba-44d6-a2f4-d68bdb599433,40762246,2439,512,15,497,0,13
356,471723a2-98ba-44d6-a2f4-d68bdb599433,40762246,2439,517,514,3,1,13
356,471723a2-98ba-44d6-a2f4-d68bdb599433,40762246,2439,615,523,92,13,13
356,24439a95-58bc-4e9a-a174-2e5d7f9588a8,40483774,5019,574,1,573,0,10
356,24439a95-58bc-4e9a-a174-2e5d7f9588a8,40483774,5019,1997,635,1362,3,10
356,24439a95-58bc-4e9a-a174-2e5d7f9588a8,40483774,5019,3195,2081,1114,4,10
356,24439a95-58bc-4e9a-a174-2e5d7f9588a8,40483774,5019,3132,947,-2185,5,10
356,24439a95-58bc-4e9a-a174-2e5d7f9588a8,40483774,5019,926,741,-185,6,10
356,24439a95-58bc-4e9a-a174-2e5d7f9588a8,40483774,5019,737,689,-48,9,10
356,24439a95-58bc-4e9a-a174-2e5d7f9588a8,40483774,5019,672,635,-37,10,10
356,801527de-afe3-464e-acfe-200d3ab1c0a9,40483774,5019,1144,15,1129,0,10
356,801527de-afe3-464e-acfe-200d3ab1c0a9,40483774,5019,1579,376,-1203,1,10
356,801527de-afe3-464e-acfe-200d3ab1c0a9,40483774,5019,346,0,-346,2,10
356,801527de-afe3-464e-acfe-200d3ab1c0a9,40483774,5019,38,0,38,4,10
356,801527de-afe3-464e-acfe-200d3ab1c0a9,40483774,5019,1404,56,1348,8,10
356,801527de-afe3-464e-acfe-200d3ab1c0a9,40483774,5019,1912,1454,458,9,10
356,801527de-afe3-464e-acfe-200d3ab1c0a9,40483774,5019,3195,1928,1267,10,10
377,a2c531a9-0202-4b18-a4ab-054a17a1983f,41684111,4546,670,73,597,0,1
377,a2c531a9-0202-4b18-a4ab-054a17a1983f,41684111,4546,680,675,5,1,1
377,32c05cda-c5f3-417f-902c-5d1761b9089d,41684111,4984,540,32,508,0,1
377,32c05cda-c5f3-417f-902c-5d1761b9089d,41684111,4984,695,616,79,1,1
377,32c05cda-c5f3-417f-902c-5d1761b9089d,41683713,5284,525,24,501,0,1
377,32c05cda-c5f3-417f-902c-5d1761b9089d,41683713,5688,700,553,147,1,1
378,87f14cfd-bf9e-4a6b-a4b7-e24b63106195,41720244,7913,2208,13,2195,0,2
378,87f14cfd-bf9e-4a6b-a4b7-e24b63106195,41720244,7913,4002,2259,1743,1,2
378,87f14cfd-bf9e-4a6b-a4b7-e24b63106195,41720244,7913,2580,0,-2580,2,2
379,3dec597a-cf2e-45dd-8a5e-49491763b801,41771294,7593,198,14,184,0,4
379,3dec597a-cf2e-45dd-8a5e-49491763b801,41771294,7593,564,213,351,1,4
379,3dec597a-cf2e-45dd-8a5e-49491763b801,41771294,7593,1012,577,435,2,4
379,3dec597a-cf2e-45dd-8a5e-49491763b801,41771294,7593,2003,1014,989,3,4
379,3dec597a-cf2e-45dd-8a5e-49491763b801,41771294,7593,2899,2063,836,4,4
379,3dec597a-cf2e-45dd-8a5e-49491763b801,41753022,9543,1937,47,1890,0,1
379,3dec597a-cf2e-45dd-8a5e-49491763b801,41753022,9543,2179,1969,210,1,1
379,a9dd39f7-df8c-4a93-b7a6-d37d5058e57e,41772372,10131,449,0,-449,0,0
379,1a9430f5-498f-4f78-aec6-ca92414024f5,41788898,11604,405,17,388,0,2
379,1a9430f5-498f-4f78-aec6-ca92414024f5,41788898,11604,470,413,57,1,2
379,1a9430f5-498f-4f78-aec6-ca92414024f5,41788898,11604,449,0,-449,2,2
379,6810a543-6863-4d4d-9e85-3a638100b426,41808227,9136,329,20,309,0,32
379,6810a543-6863-4d4d-9e85-3a638100b426,41808227,9136,542,337,205,1,32
379,6810a543-6863-4d4d-9e85-3a638100b426,41808227,9136,708,547,161,2,32
379,6810a543-6863-4d4d-9e85-3a638100b426,41808227,9136,932,713,219,3,32
379,6810a543-6863-4d4d-9e85-3a638100b426,41808227,9136,1033,934,99,4,32
379,6810a543-6863-4d4d-9e85-3a638100b426,41808227,9136,1177,1036,141,5,32
379,6810a543-6863-4d4d-9e85-3a638100b426,41808227,9136,1273,1183,90,10,32
379,6810a543-6863-4d4d-9e85-3a638100b426,41808227,9136,1316,1280,36,12,32
379,6810a543-6863-4d4d-9e85-3a638100b426,41808227,9136,1339,1318,21,13,32
379,6810a543-6863-4d4d-9e85-3a638100b426,41808227,9136,1341,1078,-263,14,32
379,6810a543-6863-4d4d-9e85-3a638100b426,41808227,9136,1077,1076,-1,15,32
379,6810a543-6863-4d4d-9e85-3a638100b426,41808227,9136,1379,1108,271,21,32
379,6810a543-6863-4d4d-9e85-3a638100b426,41808227,9136,1836,1382,454,22,32
379,6810a543-6863-4d4d-9e85-3a638100b426,41808227,9136,1841,1838,3,23,32
379,6810a543-6863-4d4d-9e85-3a638100b426,41808227,9136,1963,1856,107,24,32
379,6810a543-6863-4d4d-9e85-3a638100b426,41808227,9136,2050,1958,92,25,32
379,6810a543-6863-4d4d-9e85-3a638100b426,41808227,9136,2409,2062,347,26,32
379,6810a543-6863-4d4d-9e85-3a638100b426,41808227,9136,2411,2411,0,27,32
379,6810a543-6863-4d4d-9e85-3a638100b426,41808227,9136,2902,2433,469,29,32
379,6810a543-6863-4d4d-9e85-3a638100b426,41808227,9136,3845,2929,916,30,32
379,6810a543-6863-4d4d-9e85-3a638100b426,41808227,9136,4124,3854,270,31,32
379,6810a543-6863-4d4d-9e85-3a638100b426,41808227,9136,4454,4150,304,32,32
379,ca0ccb3f-a820-44dc-bde0-da8205f4c21d,41802900,7994,96,19,77,0,46
379,ca0ccb3f-a820-44dc-bde0-da8205f4c21d,41802900,7994,271,107,164,1,46
379,ca0ccb3f-a820-44dc-bde0-da8205f4c21d,41802900,7994,279,274,5,2,46
379,ca0ccb3f-a820-44dc-bde0-da8205f4c21d,41802900,7994,307,283,24,3,46
379,ca0ccb3f-a820-44dc-bde0-da8205f4c21d,41802900,7994,499,313,186,4,46
379,ca0ccb3f-a820-44dc-bde0-da8205f4c21d,41802900,7994,735,508,227,5,46
379,ca0ccb3f-a820-44dc-bde0-da8205f4c21d,41802900,7994,873,745,128,6,46
379,ca0ccb3f-a820-44dc-bde0-da8205f4c21d,41802900,7994,939,876,63,7,46
379,ca0ccb3f-a820-44dc-bde0-da8205f4c21d,41802900,7994,1099,944,155,8,46
379,ca0ccb3f-a820-44dc-bde0-da8205f4c21d,41802900,7994,1153,1104,49,9,46
379,ca0ccb3f-a820-44dc-bde0-da8205f4c21d,41802900,7994,1209,1160,49,10,46
379,ca0ccb3f-a820-44dc-bde0-da8205f4c21d,41802900,7994,1252,1212,40,11,46
379,ca0ccb3f-a820-44dc-bde0-da8205f4c21d,41802900,7994,1326,1265,61,12,46
379,ca0ccb3f-a820-44dc-bde0-da8205f4c21d,41802900,7994,1408,1332,76,15,46
379,ca0ccb3f-a820-44dc-bde0-da8205f4c21d,41802900,7994,1510,1411,99,16,46
379,ca0ccb3f-a820-44dc-bde0-da8205f4c21d,41802900,7994,1589,1516,73,17,46
379,ca0ccb3f-a820-44dc-bde0-da8205f4c21d,41802900,7994,1734,1591,143,18,46
379,ca0ccb3f-a820-44dc-bde0-da8205f4c21d,41802900,7994,1831,1735,96,19,46
379,ca0ccb3f-a820-44dc-bde0-da8205f4c21d,41802900,7994,1916,1834,82,20,46
379,ca0ccb3f-a820-44dc-bde0-da8205f4c21d,41802900,7994,2198,1922,276,21,46
379,ca0ccb3f-a820-44dc-bde0-da8205f4c21d,41802900,7994,2492,2215,277,22,46
379,ca0ccb3f-a820-44dc-bde0-da8205f4c21d,41802900,7994,2766,2495,271,23,46
379,ca0ccb3f-a820-44dc-bde0-da8205f4c21d,41802900,7994,2912,2775,137,24,46
379,ca0ccb3f-a820-44dc-bde0-da8205f4c21d,41802900,7994,3040,2919,121,25,46
379,ca0ccb3f-a820-44dc-bde0-da8205f4c21d,41802900,7994,3494,3060,434,26,46
379,ca0ccb3f-a820-44dc-bde0-da8205f4c21d,41802900,7994,3965,3500,465,27,46
379,ca0ccb3f-a820-44dc-bde0-da8205f4c21d,41802900,7994,4562,3988,574,28,46
379,ca0ccb3f-a820-44dc-bde0-da8205f4c21d,41802900,7994,4943,4566,377,29,46
379,ca0ccb3f-a820-44dc-bde0-da8205f4c21d,41802900,7994,5830,4967,863,30,46
379,ca0ccb3f-a820-44dc-bde0-da8205f4c21d,41802900,7994,5874,5836,38,31,46
379,ca0ccb3f-a820-44dc-bde0-da8205f4c21d,41802900,7994,6524,5912,612,32,46
379,ca0ccb3f-a820-44dc-bde0-da8205f4c21d,41802900,7994,6547,6525,22,33,46
379,ca0ccb3f-a820-44dc-bde0-da8205f4c21d,41802900,7994,6527,6401,-126,34,46
379,ca0ccb3f-a820-44dc-bde0-da8205f4c21d,41802900,7994,6481,6405,76,38,46
379,ca0ccb3f-a820-44dc-bde0-da8205f4c21d,41802900,7994,6547,6488,59,39,46
379,ca0ccb3f-a820-44dc-bde0-da8205f4c21d,41802900,7994,6516,6224,-292,46,46
379,ca0ccb3f-a820-44dc-bde0-da8205f4c21d,41807702,2545,94,5,89,0,17
379,ca0ccb3f-a820-44dc-bde0-da8205f4c21d,41807702,2545,225,95,130,1,17
379,ca0ccb3f-a820-44dc-bde0-da8205f4c21d,41807702,2545,338,236,102,2,17
379,ca0ccb3f-a820-44dc-bde0-da8205f4c21d,41807702,2545,488,351,137,3,17
379,ca0ccb3f-a820-44dc-bde0-da8205f4c21d,41807702,2545,548,496,52,7,17
379,ca0ccb3f-a820-44dc-bde0-da8205f4c21d,41807702,2545,582,552,30,12,17
379,ca0ccb3f-a820-44dc-bde0-da8205f4c21d,41807702,2545,624,591,33,14,17
379,ca0ccb3f-a820-44dc-bde0-da8205f4c21d,41807702,2545,661,625,36,15,17
379,ca0ccb3f-a820-44dc-bde0-da8205f4c21d,41807702,2545,1098,688,410,17,17
379,ca0ccb3f-a820-44dc-bde0-da8205f4c21d,41775968,6220,146,0,-146,0,47
379,ca0ccb3f-a820-44dc-bde0-da8205f4c21d,41775968,6220,423,1,422,1,47
379,ca0ccb3f-a820-44dc-bde0-da8205f4c21d,41775968,6220,576,438,138,2,47
379,ca0ccb3f-a820-44dc-bde0-da8205f4c21d,41775968,6220,1317,578,739,3,47
379,ca0ccb3f-a820-44dc-bde0-da8205f4c21d,41775968,6220,1516,1337,179,4,47
379,ca0ccb3f-a820-44dc-bde0-da8205f4c21d,41775968,6220,1603,1520,83,5,47
379,ca0ccb3f-a820-44dc-bde0-da8205f4c21d,41775968,6220,1653,1614,39,6,47
379,ca0ccb3f-a820-44dc-bde0-da8205f4c21d,41775968,6220,1712,1654,58,7,47
379,ca0ccb3f-a820-44dc-bde0-da8205f4c21d,41775968,6220,1798,1725,73,8,47
379,ca0ccb3f-a820-44dc-bde0-da8205f4c21d,41775968,6220,1800,1800,0,9,47
379,ca0ccb3f-a820-44dc-bde0-da8205f4c21d,41775968,6220,1833,1805,28,10,47
379,ca0ccb3f-a820-44dc-bde0-da8205f4c21d,41775968,6220,1894,1841,53,11,47
379,ca0ccb3f-a820-44dc-bde0-da8205f4c21d,41775968,6220,2023,1902,121,12,47
379,ca0ccb3f-a820-44dc-bde0-da8205f4c21d,41775968,6220,2075,2029,46,13,47
379,ca0ccb3f-a820-44dc-bde0-da8205f4c21d,41775968,6220,2892,2083,809,14,47
379,ca0ccb3f-a820-44dc-bde0-da8205f4c21d,41775968,6220,3681,2919,762,15,47
379,ca0ccb3f-a820-44dc-bde0-da8205f4c21d,41775968,6220,4027,3700,327,16,47
379,ca0ccb3f-a820-44dc-bde0-da8205f4c21d,41775968,6220,4442,4041,401,17,47
379,ca0ccb3f-a820-44dc-bde0-da8205f4c21d,41775968,6220,4414,4375,39,21,47
379,ca0ccb3f-a820-44dc-bde0-da8205f4c21d,41775968,6220,4466,4421,45,22,47
379,ca0ccb3f-a820-44dc-bde0-da8205f4c21d,41775968,6220,4773,4470,303,23,47
379,ca0ccb3f-a820-44dc-bde0-da8205f4c21d,41775968,6220,4713,0,-4713,47,47
380,a0228453-00e6-4ea8-b7f6-abcf15487c37,42721417,5340,833,20,813,0,2
380,a0228453-00e6-4ea8-b7f6-abcf15487c37,42721417,5340,2385,859,1526,1,2
380,a0228453-00e6-4ea8-b7f6-abcf15487c37,42721417,5340,2405,0,-2405,2,2
380,a0228453-00e6-4ea8-b7f6-abcf15487c37,42713108,8847,1128,10,1118,0,2
380,a0228453-00e6-4ea8-b7f6-abcf15487c37,42713108,8847,3286,1172,2114,1,2
380,a0228453-00e6-4ea8-b7f6-abcf15487c37,42713108,8847,3409,3300,109,2,2
380,6313adb4-7db3-48b6-92d3-e5235a610288,42721417,9864,438,5,433,0,6
380,6313adb4-7db3-48b6-92d3-e5235a610288,42721417,9864,2160,496,1664,1,6
380,6313adb4-7db3-48b6-92d3-e5235a610288,42721417,9864,3112,769,-2343,2,6
380,6313adb4-7db3-48b6-92d3-e5235a610288,42721417,9864,594,0,-594,3,6
380,6313adb4-7db3-48b6-92d3-e5235a610288,42721417,9864,1576,48,1528,5,6
380,6313adb4-7db3-48b6-92d3-e5235a610288,42721417,9864,662,243,-419,6,6
380,30d3b109-cf78-46e7-9b95-731a6f252071,42715147,13311,2071,63,2008,0,1
380,30d3b109-cf78-46e7-9b95-731a6f252071,42715147,13311,2153,0,-2153,1,1
380,f7d4b81d-7395-4da1-8240-264859063811,42724380,9063,172,22,150,0,0
380,58a16d39-ec77-45ab-9e25-d4c77da84193,42731505,2996,1223,40,1183,0,10
380,58a16d39-ec77-45ab-9e25-d4c77da84193,42731505,2996,1549,1273,276,5,10
380,58a16d39-ec77-45ab-9e25-d4c77da84193,42731505,2996,1531,107,-1424,9,10
380,58a16d39-ec77-45ab-9e25-d4c77da84193,42731505,2996,49,0,-49,10,10
380,58a16d39-ec77-45ab-9e25-d4c77da84193,42732842,4970,598,5,593,0,5
380,58a16d39-ec77-45ab-9e25-d4c77da84193,42732842,4970,1015,602,413,1,5
380,58a16d39-ec77-45ab-9e25-d4c77da84193,42732842,4970,1620,1018,602,2,5
380,58a16d39-ec77-45ab-9e25-d4c77da84193,42732842,4970,2296,1621,675,3,5
380,58a16d39-ec77-45ab-9e25-d4c77da84193,42732842,4970,2976,2325,651,4,5
380,58a16d39-ec77-45ab-9e25-d4c77da84193,42732842,4970,3523,2983,540,5,5
381,aa261d12-0fa8-4831-b0f1-1c82c8c334e5,42723401,8354,362,7,355,0,0
381,aa261d12-0fa8-4831-b0f1-1c82c8c334e5,42732304,1797,350,41,309,0,0
381,aa261d12-0fa8-4831-b0f1-1c82c8c334e5,42730396,3912,265,22,243,0,3
381,aa261d12-0fa8-4831-b0f1-1c82c8c334e5,42730396,3912,834,274,560,1,3
381,aa261d12-0fa8-4831-b0f1-1c82c8c334e5,42730396,3912,1160,842,318,2,3
381,aa261d12-0fa8-4831-b0f1-1c82c8c334e5,42730396,3912,1162,1162,0,3,3
381,aa261d12-0fa8-4831-b0f1-1c82c8c334e5,42721115,5598,434,45,389,0,4
381,aa261d12-0fa8-4831-b0f1-1c82c8c334e5,42721115,5598,1945,446,1499,1,4
381,aa261d12-0fa8-4831-b0f1-1c82c8c334e5,42721115,5598,2626,1975,651,2,4
381,aa261d12-0fa8-4831-b0f1-1c82c8c334e5,42721115,5598,3322,2631,691,3,4
381,aa261d12-0fa8-4831-b0f1-1c82c8c334e5,42721115,5598,4151,3325,826,4,4
381,6ba8724d-0e19-4066-a339-ba906358013f,42723401,9624,556,21,535,0,3
381,6ba8724d-0e19-4066-a339-ba906358013f,42723401,9624,995,569,426,1,3
381,6ba8724d-0e19-4066-a339-ba906358013f,42723401,9624,1668,1039,629,2,3
381,6ba8724d-0e19-4066-a339-ba906358013f,42723401,9624,1782,1685,97,3,3
381,6ba8724d-0e19-4066-a339-ba906358013f,42731648,2508,121,7,114,0,9
381,6ba8724d-0e19-4066-a339-ba906358013f,42731648,2508,532,122,410,1,9
381,6ba8724d-0e19-4066-a339-ba906358013f,42731648,2508,763,543,220,2,9
381,6ba8724d-0e19-4066-a339-ba906358013f,42731648,2508,1005,790,215,3,9
381,6ba8724d-0e19-4066-a339-ba906358013f,42731648,2508,1061,1032,29,4,9
381,6ba8724d-0e19-4066-a339-ba906358013f,42731648,2508,1048,0,-1048,5,9
381,6ba8724d-0e19-4066-a339-ba906358013f,42731648,2508,555,6,549,6,9
381,6ba8724d-0e19-4066-a339-ba906358013f,42731648,2508,1061,610,451,7,9
381,6ba8724d-0e19-4066-a339-ba906358013f,42731648,2508,1025,117,-908,8,9
381,6ba8724d-0e19-4066-a339-ba906358013f,42731648,2508,115,112,-3,9,9
381,56dff423-9b67-4ecd-a0ac-fdfac97bf877,42723401,11147,246,2,244,0,20
381,56dff423-9b67-4ecd-a0ac-fdfac97bf877,42723401,11147,249,248,1,1,20
381,56dff423-9b67-4ecd-a0ac-fdfac97bf877,42723401,11147,495,260,235,2,20
381,56dff423-9b67-4ecd-a0ac-fdfac97bf877,42723401,11147,472,189,-283,4,20
381,56dff423-9b67-4ecd-a0ac-fdfac97bf877,42723401,11147,176,61,-115,5,20
381,56dff423-9b67-4ecd-a0ac-fdfac97bf877,42723401,11147,45,0,-45,6,20
381,56dff423-9b67-4ecd-a0ac-fdfac97bf877,42723401,11147,744,47,697,19,20
381,56dff423-9b67-4ecd-a0ac-fdfac97bf877,42723401,11147,812,762,50,20,20
381,56dff423-9b67-4ecd-a0ac-fdfac97bf877,42733993,2983,98,1,97,0,0
380,b36e87f0-afbf-4e05-9ed0-232d77e6abc9,42741465,4647,386,0,-386,0,2
380,b36e87f0-afbf-4e05-9ed0-232d77e6abc9,42741465,4647,1252,317,935,1,2
380,b36e87f0-afbf-4e05-9ed0-232d77e6abc9,42741465,4647,517,0,-517,2,2
380,b36e87f0-afbf-4e05-9ed0-232d77e6abc9,42741049,8813,1388,20,1368,0,3
380,b36e87f0-afbf-4e05-9ed0-232d77e6abc9,42741049,8813,1961,1412,549,1,3
380,b36e87f0-afbf-4e05-9ed0-232d77e6abc9,42741049,8813,1885,989,-896,2,3
380,b36e87f0-afbf-4e05-9ed0-232d77e6abc9,42741049,8813,945,0,-945,3,3
381,5115d2f9-bf13-4da2-8985-9ffa6cd6b125,42763760,4600,308,8,300,0,3
381,5115d2f9-bf13-4da2-8985-9ffa6cd6b125,42763760,4600,3153,360,2793,1,3
381,5115d2f9-bf13-4da2-8985-9ffa6cd6b125,42763760,4600,3142,1977,-1165,2,3
381,5115d2f9-bf13-4da2-8985-9ffa6cd6b125,42763760,4600,1888,0,-1888,3,3
381,5115d2f9-bf13-4da2-8985-9ffa6cd6b125,42764304,5527,486,54,432,0,1
381,5115d2f9-bf13-4da2-8985-9ffa6cd6b125,42764304,5527,1218,426,792,1,1
380,649c574d-1560-41f0-ab0e-5ede2a87dec4,42763517,9635,1178,20,1158,0,6
380,649c574d-1560-41f0-ab0e-5ede2a87dec4,42763517,9635,3310,1187,2123,1,6
380,649c574d-1560-41f0-ab0e-5ede2a87dec4,42763517,9635,6433,3332,3101,2,6
380,649c574d-1560-41f0-ab0e-5ede2a87dec4,42763517,9635,7014,6168,-846,3,6
380,649c574d-1560-41f0-ab0e-5ede2a87dec4,42763517,9635,6155,6059,-96,4,6
380,649c574d-1560-41f0-ab0e-5ede2a87dec4,42763517,9635,6035,599,-5436,5,6
380,649c574d-1560-41f0-ab0e-5ede2a87dec4,42763517,9635,518,0,-518,6,6
380,e4b28ee7-3119-4782-be77-a80832bff04d,42766623,8687,2221,7,2214,0,0
381,27b2d758-7e04-4320-b2c0-b7a1abe54d07,42766623,8687,3646,29,3617,0,2
381,27b2d758-7e04-4320-b2c0-b7a1abe54d07,42766623,8687,5175,3731,1444,1,2
381,27b2d758-7e04-4320-b2c0-b7a1abe54d07,42766623,8687,6303,5188,1115,2,2
381,18f1c6a6-90fc-441d-8c18-edc643af9a28,42767657,5955,1203,22,1181,0,1
381,18f1c6a6-90fc-441d-8c18-edc643af9a28,42767657,5955,859,0,-859,1,1
384,5dfa1975-ed21-4946-a0fb-43fdd779af50,42738079,5200,156,4,152,0,69
384,5dfa1975-ed21-4946-a0fb-43fdd779af50,42738079,5200,270,158,112,1,69
384,5dfa1975-ed21-4946-a0fb-43fdd779af50,42738079,5200,322,271,51,2,69
384,5dfa1975-ed21-4946-a0fb-43fdd779af50,42738079,5200,338,324,14,3,69
384,5dfa1975-ed21-4946-a0fb-43fdd779af50,42738079,5200,431,339,92,7,69
384,5dfa1975-ed21-4946-a0fb-43fdd779af50,42738079,5200,436,433,3,8,69
384,5dfa1975-ed21-4946-a0fb-43fdd779af50,42738079,5200,504,438,66,20,69
384,5dfa1975-ed21-4946-a0fb-43fdd779af50,42738079,5200,614,506,108,21,69
384,5dfa1975-ed21-4946-a0fb-43fdd779af50,42738079,5200,744,617,127,22,69
384,5dfa1975-ed21-4946-a0fb-43fdd779af50,42738079,5200,753,0,-753,23,69
384,5dfa1975-ed21-4946-a0fb-43fdd779af50,42738079,5200,1174,36,1138,24,69
384,5dfa1975-ed21-4946-a0fb-43fdd779af50,42738079,5200,1392,1195,197,25,69
384,5dfa1975-ed21-4946-a0fb-43fdd779af50,42738079,5200,2242,1418,824,26,69
384,5dfa1975-ed21-4946-a0fb-43fdd779af50,42738079,5200,3637,2258,1379,27,69
384,5dfa1975-ed21-4946-a0fb-43fdd779af50,42738079,5200,3631,2975,-656,30,69
384,5dfa1975-ed21-4946-a0fb-43fdd779af50,42738079,5200,2918,2002,-916,31,69
384,5dfa1975-ed21-4946-a0fb-43fdd779af50,42738079,5200,1974,1716,-258,32,69
384,5dfa1975-ed21-4946-a0fb-43fdd779af50,42738079,5200,1722,1563,159,33,69
384,5dfa1975-ed21-4946-a0fb-43fdd779af50,42738079,5200,1738,1723,15,34,69
384,5dfa1975-ed21-4946-a0fb-43fdd779af50,42738079,5200,1774,1740,34,35,69
384,5dfa1975-ed21-4946-a0fb-43fdd779af50,42738079,5200,1789,1775,14,36,69
384,5dfa1975-ed21-4946-a0fb-43fdd779af50,42738079,5200,1802,1791,11,37,69
384,5dfa1975-ed21-4946-a0fb-43fdd779af50,42738079,5200,1833,1804,29,38,69
384,5dfa1975-ed21-4946-a0fb-43fdd779af50,42738079,5200,1845,1834,11,39,69
384,5dfa1975-ed21-4946-a0fb-43fdd779af50,42738079,5200,1903,1846,57,40,69
384,5dfa1975-ed21-4946-a0fb-43fdd779af50,42738079,5200,1946,1904,42,41,69
384,5dfa1975-ed21-4946-a0fb-43fdd779af50,42738079,5200,1987,1947,40,42,69
384,5dfa1975-ed21-4946-a0fb-43fdd779af50,42738079,5200,2020,1988,32,43,69
384,5dfa1975-ed21-4946-a0fb-43fdd779af50,42738079,5200,2044,2021,23,44,69
384,5dfa1975-ed21-4946-a0fb-43fdd779af50,42738079,5200,2080,2045,35,45,69
384,5dfa1975-ed21-4946-a0fb-43fdd779af50,42738079,5200,2133,2081,52,46,69
384,5dfa1975-ed21-4946-a0fb-43fdd779af50,42738079,5200,2140,2134,6,47,69
384,5dfa1975-ed21-4946-a0fb-43fdd779af50,42738079,5200,2210,2142,68,48,69
384,5dfa1975-ed21-4946-a0fb-43fdd779af50,42738079,5200,2289,2212,77,49,69
384,5dfa1975-ed21-4946-a0fb-43fdd779af50,42738079,5200,2400,2290,110,50,69
384,5dfa1975-ed21-4946-a0fb-43fdd779af50,42738079,5200,2510,2403,107,52,69
384,5dfa1975-ed21-4946-a0fb-43fdd779af50,42738079,5200,2585,2511,74,53,69
384,5dfa1975-ed21-4946-a0fb-43fdd779af50,42738079,5200,2684,2587,97,54,69
384,5dfa1975-ed21-4946-a0fb-43fdd779af50,42738079,5200,2731,2690,41,55,69
384,5dfa1975-ed21-4946-a0fb-43fdd779af50,42738079,5200,2783,2734,49,56,69
384,5dfa1975-ed21-4946-a0fb-43fdd779af50,42738079,5200,2868,2784,84,57,69
384,5dfa1975-ed21-4946-a0fb-43fdd779af50,42738079,5200,3192,2873,319,58,69
384,5dfa1975-ed21-4946-a0fb-43fdd779af50,42738079,5200,3269,3195,74,59,69
384,5dfa1975-ed21-4946-a0fb-43fdd779af50,42738079,5200,3323,3271,52,60,69
384,5dfa1975-ed21-4946-a0fb-43fdd779af50,42738079,5200,3354,3324,30,61,69
384,5dfa1975-ed21-4946-a0fb-43fdd779af50,42738079,5200,3380,3355,25,62,69
384,5dfa1975-ed21-4946-a0fb-43fdd779af50,42738079,5200,3384,3382,2,63,69
384,5dfa1975-ed21-4946-a0fb-43fdd779af50,42738079,5200,3507,3383,124,68,69
384,5dfa1975-ed21-4946-a0fb-43fdd779af50,42738079,5200,3637,3508,129,69,69
385,44abeeef-74e6-4df5-9182-1e55fada70a9,42782785,3915,1121,7,1114,0,1
385,44abeeef-74e6-4df5-9182-1e55fada70a9,42782785,3915,1244,1141,103,1,1
385,f5d8795b-3ebf-4a18-80df-6ef4aa29c7d1,42779953,5886,730,57,673,0,109
385,f5d8795b-3ebf-4a18-80df-6ef4aa29c7d1,42779953,5886,1185,981,204,8,109
385,f5d8795b-3ebf-4a18-80df-6ef4aa29c7d1,42779953,5886,1897,1213,684,15,109
385,f5d8795b-3ebf-4a18-80df-6ef4aa29c7d1,42779953,5886,2119,1917,202,21,109
385,f5d8795b-3ebf-4a18-80df-6ef4aa29c7d1,42779953,5886,2763,2141,622,28,109
385,f5d8795b-3ebf-4a18-80df-6ef4aa29c7d1,42779953,5886,3171,2799,372,33,109
385,f5d8795b-3ebf-4a18-80df-6ef4aa29c7d1,42779953,5886,3195,3183,12,34,109
385,f5d8795b-3ebf-4a18-80df-6ef4aa29c7d1,42779953,5886,3809,3227,582,41,109
385,f5d8795b-3ebf-4a18-80df-6ef4aa29c7d1,42779953,5886,3947,3825,122,53,109
385,f5d8795b-3ebf-4a18-80df-6ef4aa29c7d1,42779953,5886,3901,3706,-195,59,109
385,f5d8795b-3ebf-4a18-80df-6ef4aa29c7d1,42779953,5886,4002,3708,294,60,109
385,f5d8795b-3ebf-4a18-80df-6ef4aa29c7d1,42779953,5886,3682,3557,-125,61,109
385,f5d8795b-3ebf-4a18-80df-6ef4aa29c7d1,42779953,5886,3867,3587,280,63,109
385,f5d8795b-3ebf-4a18-80df-6ef4aa29c7d1,42779953,5886,3875,3869,6,64,109
385,f5d8795b-3ebf-4a18-80df-6ef4aa29c7d1,42779953,5886,4043,3906,137,74,109
385,f5d8795b-3ebf-4a18-80df-6ef4aa29c7d1,42779953,5886,4105,4049,56,75,109
385,f5d8795b-3ebf-4a18-80df-6ef4aa29c7d1,42779953,5886,4220,4124,-96,76,109
385,f5d8795b-3ebf-4a18-80df-6ef4aa29c7d1,42779953,5886,4362,4192,170,109,109
386,3ff86310-1ad7-43f2-a5b5-eb8d7959dd08,42783247,10830,211,5,206,0,10
386,3ff86310-1ad7-43f2-a5b5-eb8d7959dd08,42783247,10830,481,214,267,1,10
386,3ff86310-1ad7-43f2-a5b5-eb8d7959dd08,42783247,10830,880,490,390,2,10
386,3ff86310-1ad7-43f2-a5b5-eb8d7959dd08,42783247,10830,1134,881,253,3,10
386,3ff86310-1ad7-43f2-a5b5-eb8d7959dd08,42783247,10830,1644,1141,503,4,10
386,3ff86310-1ad7-43f2-a5b5-eb8d7959dd08,42783247,10830,4021,1663,2358,5,10
386,3ff86310-1ad7-43f2-a5b5-eb8d7959dd08,42783247,10830,7564,4068,3496,6,10
386,3ff86310-1ad7-43f2-a5b5-eb8d7959dd08,42783247,10830,9910,7642,2268,7,10
386,3ff86310-1ad7-43f2-a5b5-eb8d7959dd08,42783247,10830,9884,9543,-341,10,10
386,3ff86310-1ad7-43f2-a5b5-eb8d7959dd08,42786749,8208,226,1,225,0,73
386,3ff86310-1ad7-43f2-a5b5-eb8d7959dd08,42786749,8208,440,247,193,1,73
386,3ff86310-1ad7-43f2-a5b5-eb8d7959dd08,42786749,8208,679,447,232,2,73
386,3ff86310-1ad7-43f2-a5b5-eb8d7959dd08,42786749,8208,720,680,40,3,73
386,3ff86310-1ad7-43f2-a5b5-eb8d7959dd08,42786749,8208,745,690,-55,4,73
386,3ff86310-1ad7-43f2-a5b5-eb8d7959dd08,42786749,8208,920,691,229,5,73
386,3ff86310-1ad7-43f2-a5b5-eb8d7959dd08,42786749,8208,998,926,72,6,73
386,3ff86310-1ad7-43f2-a5b5-eb8d7959dd08,42786749,8208,1055,1000,55,7,73
386,3ff86310-1ad7-43f2-a5b5-eb8d7959dd08,42786749,8208,1045,967,-78,8,73
386,3ff86310-1ad7-43f2-a5b5-eb8d7959dd08,42786749,8208,965,885,-80,9,73
386,3ff86310-1ad7-43f2-a5b5-eb8d7959dd08,42786749,8208,1063,900,163,10,73
386,3ff86310-1ad7-43f2-a5b5-eb8d7959dd08,42786749,8208,1150,1064,86,11,73
386,3ff86310-1ad7-43f2-a5b5-eb8d7959dd08,42786749,8208,1267,1152,115,12,73
386,3ff86310-1ad7-43f2-a5b5-eb8d7959dd08,42786749,8208,1337,1275,62,13,73
386,3ff86310-1ad7-43f2-a5b5-eb8d7959dd08,42786749,8208,1373,1312,-61,14,73
386,3ff86310-1ad7-43f2-a5b5-eb8d7959dd08,42786749,8208,1398,1314,84,15,73
386,3ff86310-1ad7-43f2-a5b5-eb8d7959dd08,42786749,8208,1412,1289,-123,16,73
386,3ff86310-1ad7-43f2-a5b5-eb8d7959dd08,42786749,8208,1324,1271,53,17,73
386,3ff86310-1ad7-43f2-a5b5-eb8d7959dd08,42786749,8208,1399,1288,-111,18,73
386,3ff86310-1ad7-43f2-a5b5-eb8d7959dd08,42786749,8208,1284,1173,-111,19,73
386,3ff86310-1ad7-43f2-a5b5-eb8d7959dd08,42786749,8208,1436,1209,227,20,73
386,3ff86310-1ad7-43f2-a5b5-eb8d7959dd08,42786749,8208,1639,1438,201,21,73
386,3ff86310-1ad7-43f2-a5b5-eb8d7959dd08,42786749,8208,1973,1649,324,23,73
386,3ff86310-1ad7-43f2-a5b5-eb8d7959dd08,42786749,8208,2483,1986,497,24,73
386,3ff86310-1ad7-43f2-a5b5-eb8d7959dd08,42786749,8208,2570,2486,84,25,73
386,3ff86310-1ad7-43f2-a5b5-eb8d7959dd08,42786749,8208,2740,2572,168,26,73
386,3ff86310-1ad7-43f2-a5b5-eb8d7959dd08,42786749,8208,2770,2634,-136,27,73
386,3ff86310-1ad7-43f2-a5b5-eb8d7959dd08,42786749,8208,3147,2649,498,28,73
386,3ff86310-1ad7-43f2-a5b5-eb8d7959dd08,42786749,8208,3205,3040,-165,29,73
386,3ff86310-1ad7-43f2-a5b5-eb8d7959dd08,42786749,8208,3029,2866,-163,30,73
386,3ff86310-1ad7-43f2-a5b5-eb8d7959dd08,42786749,8208,2958,2868,90,31,73
386,3ff86310-1ad7-43f2-a5b5-eb8d7959dd08,42786749,8208,3022,2958,64,32,73
386,3ff86310-1ad7-43f2-a5b5-eb8d7959dd08,42786749,8208,3162,3025,137,33,73
386,3ff86310-1ad7-43f2-a5b5-eb8d7959dd08,42786749,8208,3409,3166,243,34,73
386,3ff86310-1ad7-43f2-a5b5-eb8d7959dd08,42786749,8208,3737,3412,325,35,73
386,3ff86310-1ad7-43f2-a5b5-eb8d7959dd08,42786749,8208,4025,3760,265,36,73
386,3ff86310-1ad7-43f2-a5b5-eb8d7959dd08,42786749,8208,4546,4033,513,37,73
386,3ff86310-1ad7-43f2-a5b5-eb8d7959dd08,42786749,8208,4986,4565,421,38,73
386,3ff86310-1ad7-43f2-a5b5-eb8d7959dd08,42786749,8208,5128,4997,131,39,73
386,3ff86310-1ad7-43f2-a5b5-eb8d7959dd08,42786749,8208,5311,5132,179,40,73
386,3ff86310-1ad7-43f2-a5b5-eb8d7959dd08,42786749,8208,5388,5315,73,41,73
386,3ff86310-1ad7-43f2-a5b5-eb8d7959dd08,42786749,8208,5847,5390,457,42,73
386,3ff86310-1ad7-43f2-a5b5-eb8d7959dd08,42786749,8208,6094,5851,243,43,73
386,3ff86310-1ad7-43f2-a5b5-eb8d7959dd08,42786749,8208,6643,6110,533,44,73
386,3ff86310-1ad7-43f2-a5b5-eb8d7959dd08,42786749,8208,7246,6644,602,45,73
386,3ff86310-1ad7-43f2-a5b5-eb8d7959dd08,42786749,8208,7288,7248,40,46,73
386,3ff86310-1ad7-43f2-a5b5-eb8d7959dd08,42786749,8208,7275,7139,-136,49,73
386,3ff86310-1ad7-43f2-a5b5-eb8d7959dd08,42786749,920,0,0,0,56,73
386,3ff86310-1ad7-43f2-a5b5-eb8d7959dd08,42786749,19764,124,6,118,60,73
386,3ff86310-1ad7-43f2-a5b5-eb8d7959dd08,42786749,19764,144,31,-113,61,73
386,3ff86310-1ad7-43f2-a5b5-eb8d7959dd08,42786749,16220,161,132,29,62,73
386,3ff86310-1ad7-43f2-a5b5-eb8d7959dd08,42786749,16520,128,0,-128,64,73
386,3ff86310-1ad7-43f2-a5b5-eb8d7959dd08,42786749,16492,103,6,97,65,73
386,3ff86310-1ad7-43f2-a5b5-eb8d7959dd08,42786749,16492,101,0,-101,66,73
386,3ff86310-1ad7-43f2-a5b5-eb8d7959dd08,42786749,16492,21,3,18,67,73
386,3ff86310-1ad7-43f2-a5b5-eb8d7959dd08,42786749,16492,124,24,100,68,73
386,3ff86310-1ad7-43f2-a5b5-eb8d7959dd08,42786749,16492,137,0,-137,69,73
386,3ff86310-1ad7-43f2-a5b5-eb8d7959dd08,42786749,16492,237,93,144,70,73
386,3ff86310-1ad7-43f2-a5b5-eb8d7959dd08,42786749,16492,933,254,679,71,73
386,3ff86310-1ad7-43f2-a5b5-eb8d7959dd08,42786749,16492,1298,960,338,72,73
386,3ff86310-1ad7-43f2-a5b5-eb8d7959dd08,42786749,16492,1244,0,-1244,73,73
386,3ff86310-1ad7-43f2-a5b5-eb8d7959dd08,42788510,5666,142,2,140,0,120
386,3ff86310-1ad7-43f2-a5b5-eb8d7959dd08,42788510,5666,376,145,231,1,120
386,3ff86310-1ad7-43f2-a5b5-eb8d7959dd08,42788510,5666,534,379,155,2,120
386,3ff86310-1ad7-43f2-a5b5-eb8d7959dd08,42788510,5666,682,539,143,3,120
386,3ff86310-1ad7-43f2-a5b5-eb8d7959dd08,42788510,5666,784,687,97,4,120
386,3ff86310-1ad7-43f2-a5b5-eb8d7959dd08,42788510,5666,818,788,30,5,120
386,3ff86310-1ad7-43f2-a5b5-eb8d7959dd08,42788510,5666,874,820,54,6,120
386,3ff86310-1ad7-43f2-a5b5-eb8d7959dd08,42788510,5666,958,878,80,7,120
386,3ff86310-1ad7-43f2-a5b5-eb8d7959dd08,42788510,5666,908,667,-241,8,120
386,3ff86310-1ad7-43f2-a5b5-eb8d7959dd08,42788510,5666,910,668,242,9,120
386,3ff86310-1ad7-43f2-a5b5-eb8d7959dd08,42788510,5666,949,911,38,10,120
386,3ff86310-1ad7-43f2-a5b5-eb8d7959dd08,42788510,5666,1091,951,140,11,120
386,3ff86310-1ad7-43f2-a5b5-eb8d7959dd08,42788510,5666,1117,1100,17,12,120
386,3ff86310-1ad7-43f2-a5b5-eb8d7959dd08,42788510,5666,1214,1122,92,13,120
386,3ff86310-1ad7-43f2-a5b5-eb8d7959dd08,42788510,5666,1338,1217,121,15,120
386,3ff86310-1ad7-43f2-a5b5-eb8d7959dd08,42788510,5666,1294,1201,-93,16,120
386,3ff86310-1ad7-43f2-a5b5-eb8d7959dd08,42788510,5666,1251,1214,37,17,120
386,3ff86310-1ad7-43f2-a5b5-eb8d7959dd08,42788510,5666,1304,1253,51,18,120
386,3ff86310-1ad7-43f2-a5b5-eb8d7959dd08,42788510,5666,1447,1306,141,19,120
386,3ff86310-1ad7-43f2-a5b5-eb8d7959dd08,42788510,5666,1566,1454,112,20,120
386,3ff86310-1ad7-43f2-a5b5-eb8d7959dd08,42788510,5666,1579,1568,11,21,120
386,3ff86310-1ad7-43f2-a5b5-eb8d7959dd08,42788510,5666,1649,1584,65,22,120
386,3ff86310-1ad7-43f2-a5b5-eb8d7959dd08,42788510,5666,1685,1651,34,23,120
386,3ff86310-1ad7-43f2-a5b5-eb8d7959dd08,42788510,5666,1704,1686,18,24,120
386,3ff86310-1ad7-43f2-a5b5-eb8d7959dd08,42788510,5666,1717,1706,11,25,120
386,3ff86310-1ad7-43f2-a5b5-eb8d7959dd08,42788510,5666,1820,1719,101,26,120
386,3ff86310-1ad7-43f2-a5b5-eb8d7959dd08,42788510,5666,2152,1823,329,58,120
386,3ff86310-1ad7-43f2-a5b5-eb8d7959dd08,42788510,5666,2687,2153,534,59,120
386,3ff86310-1ad7-43f2-a5b5-eb8d7959dd08,42788510,5666,3769,2692,1077,60,120
386,3ff86310-1ad7-43f2-a5b5-eb8d7959dd08,42788510,5666,4020,3792,228,61,120
386,3ff86310-1ad7-43f2-a5b5-eb8d7959dd08,42788510,5666,4172,3953,-219,62,120
386,3ff86310-1ad7-43f2-a5b5-eb8d7959dd08,42788510,5666,4048,3956,92,64,120
386,3ff86310-1ad7-43f2-a5b5-eb8d7959dd08,42788510,5666,4047,3924,-123,65,120
386,3ff86310-1ad7-43f2-a5b5-eb8d7959dd08,42788510,5666,4195,3958,237,66,120
386,3ff86310-1ad7-43f2-a5b5-eb8d7959dd08,42788510,5666,4746,4212,534,67,120
386,3ff86310-1ad7-43f2-a5b5-eb8d7959dd08,42788510,5666,4739,4616,-123,68,120
386,3ff86310-1ad7-43f2-a5b5-eb8d7959dd08,42788510,5666,4608,4169,-439,69,120
386,3ff86310-1ad7-43f2-a5b5-eb8d7959dd08,42788510,5666,4165,3026,-1139,70,120
386,3ff86310-1ad7-43f2-a5b5-eb8d7959dd08,42788510,5666,2970,925,-2045,71,120
386,3ff86310-1ad7-43f2-a5b5-eb8d7959dd08,42788510,5666,901,0,-901,72,120
386,3ff86310-1ad7-43f2-a5b5-eb8d7959dd08,42788510,5666,726,5,721,73,120
386,3ff86310-1ad7-43f2-a5b5-eb8d7959dd08,42788510,5666,996,737,259,74,120
386,3ff86310-1ad7-43f2-a5b5-eb8d7959dd08,42788510,5666,1470,1004,466,75,120
386,3ff86310-1ad7-43f2-a5b5-eb8d7959dd08,42788510,5666,1490,872,-618,76,120
386,3ff86310-1ad7-43f2-a5b5-eb8d7959dd08,42788510,5666,864,0,-864,77,120
386,3ff86310-1ad7-43f2-a5b5-eb8d7959dd08,42788510,5666,428,19,409,88,120
386,3ff86310-1ad7-43f2-a5b5-eb8d7959dd08,42788510,5666,404,2,-402,89,120
386,3ff86310-1ad7-43f2-a5b5-eb8d7959dd08,42788510,5666,979,42,937,95,120
386,3ff86310-1ad7-43f2-a5b5-eb8d7959dd08,42788510,5666,2683,1024,1659,96,120
386,3ff86310-1ad7-43f2-a5b5-eb8d7959dd08,42788510,5666,2908,1160,-1748,97,120
386,3ff86310-1ad7-43f2-a5b5-eb8d7959dd08,42788510,5666,1124,497,-627,98,120
386,3ff86310-1ad7-43f2-a5b5-eb8d7959dd08,42788510,5666,476,0,-476,99,120
386,3ff86310-1ad7-43f2-a5b5-eb8d7959dd08,42788510,5666,511,2,509,111,120
386,3ff86310-1ad7-43f2-a5b5-eb8d7959dd08,42788510,5666,2700,539,2161,112,120
386,3ff86310-1ad7-43f2-a5b5-eb8d7959dd08,42788510,5666,4301,2744,1557,113,120
386,3ff86310-1ad7-43f2-a5b5-eb8d7959dd08,42788510,5666,4746,4319,427,114,120
386,3ff86310-1ad7-43f2-a5b5-eb8d7959dd08,42788510,5666,4729,4560,-169,116,120
386,3ff86310-1ad7-43f2-a5b5-eb8d7959dd08,42788510,5666,4746,4563,183,117,120
386,3ff86310-1ad7-43f2-a5b5-eb8d7959dd08,42788510,5666,4742,4149,-593,118,120
386,3ff86310-1ad7-43f2-a5b5-eb8d7959dd08,42788510,5666,4143,1118,-3025,119,120
386,3ff86310-1ad7-43f2-a5b5-eb8d7959dd08,42788510,5666,1092,0,-1092,120,120
386,753f2380-99ac-4cc7-a751-9a6f86a18242,42787529,4354,499,21,478,0,112
386,753f2380-99ac-4cc7-a751-9a6f86a18242,42787529,4354,1595,571,1024,1,112
386,753f2380-99ac-4cc7-a751-9a6f86a18242,42787529,4354,1015,554,-461,2,112
386,753f2380-99ac-4cc7-a751-9a6f86a18242,42787529,4354,667,549,118,3,112
386,753f2380-99ac-4cc7-a751-9a6f86a18242,42787529,4354,665,523,-142,4,112
386,753f2380-99ac-4cc7-a751-9a6f86a18242,42787529,4354,522,74,-448,5,112
386,753f2380-99ac-4cc7-a751-9a6f86a18242,42787529,4354,66,0,-66,6,112
386,753f2380-99ac-4cc7-a751-9a6f86a18242,42787529,4354,407,3,404,7,112
386,753f2380-99ac-4cc7-a751-9a6f86a18242,42787529,4354,802,418,384,8,112
386,753f2380-99ac-4cc7-a751-9a6f86a18242,42787529,4354,1073,828,245,9,112
386,753f2380-99ac-4cc7-a751-9a6f86a18242,42787529,4354,1152,1074,78,10,112
386,753f2380-99ac-4cc7-a751-9a6f86a18242,42787529,4354,1157,1036,121,11,112
386,753f2380-99ac-4cc7-a751-9a6f86a18242,42787529,4354,1400,1166,234,12,112
386,753f2380-99ac-4cc7-a751-9a6f86a18242,42787529,4354,1589,1402,187,13,112
386,753f2380-99ac-4cc7-a751-9a6f86a18242,42787529,4354,1648,1510,138,14,112
386,753f2380-99ac-4cc7-a751-9a6f86a18242,42787529,4354,1680,1636,44,15,112
386,753f2380-99ac-4cc7-a751-9a6f86a18242,42787529,4354,1854,1693,161,16,112
386,753f2380-99ac-4cc7-a751-9a6f86a18242,42787529,4354,2452,1859,593,17,112
386,753f2380-99ac-4cc7-a751-9a6f86a18242,42787529,4354,3074,2498,576,18,112
386,753f2380-99ac-4cc7-a751-9a6f86a18242,42787529,4354,3434,3122,312,19,112
386,753f2380-99ac-4cc7-a751-9a6f86a18242,42787529,4354,3432,2818,-614,20,112
386,753f2380-99ac-4cc7-a751-9a6f86a18242,42787529,4354,2784,2083,-701,21,112
386,753f2380-99ac-4cc7-a751-9a6f86a18242,42787529,4354,2059,1379,-680,22,112
386,753f2380-99ac-4cc7-a751-9a6f86a18242,42787529,4354,1372,611,-761,23,112
386,753f2380-99ac-4cc7-a751-9a6f86a18242,42787529,4354,600,0,-600,24,112
386,753f2380-99ac-4cc7-a751-9a6f86a18242,42787529,4354,498,5,493,26,112
386,753f2380-99ac-4cc7-a751-9a6f86a18242,42787529,4354,946,507,439,27,112
386,753f2380-99ac-4cc7-a751-9a6f86a18242,42787529,4354,1157,950,207,28,112
386,753f2380-99ac-4cc7-a751-9a6f86a18242,42787529,4354,1332,1179,153,29,112
386,753f2380-99ac-4cc7-a751-9a6f86a18242,42787529,4354,1425,1339,86,30,112
386,753f2380-99ac-4cc7-a751-9a6f86a18242,42787529,4354,1424,1200,-224,31,112
386,753f2380-99ac-4cc7-a751-9a6f86a18242,42787529,4354,1254,1203,51,32,112
386,753f2380-99ac-4cc7-a751-9a6f86a18242,42787529,4354,1341,1256,85,33,112
386,753f2380-99ac-4cc7-a751-9a6f86a18242,42787529,4354,1784,1344,440,34,112
386,753f2380-99ac-4cc7-a751-9a6f86a18242,42787529,4354,2022,1795,227,35,112
386,753f2380-99ac-4cc7-a751-9a6f86a18242,42787529,4354,2198,2034,164,36,112
386,753f2380-99ac-4cc7-a751-9a6f86a18242,42787529,4354,2388,2201,187,40,112
386,753f2380-99ac-4cc7-a751-9a6f86a18242,42787529,4354,2447,2391,56,41,112
386,753f2380-99ac-4cc7-a751-9a6f86a18242,42787529,4354,2559,2453,106,42,112
386,753f2380-99ac-4cc7-a751-9a6f86a18242,42787529,4354,2586,2561,25,43,112
386,753f2380-99ac-4cc7-a751-9a6f86a18242,42787529,4354,2602,2587,15,44,112
386,753f2380-99ac-4cc7-a751-9a6f86a18242,42787529,4354,2671,2603,68,46,112
386,753f2380-99ac-4cc7-a751-9a6f86a18242,42787529,4354,2748,2672,76,47,112
386,753f2380-99ac-4cc7-a751-9a6f86a18242,42787529,4354,2765,2413,-352,48,112
386,753f2380-99ac-4cc7-a751-9a6f86a18242,42787529,4354,2394,2120,-274,49,112
386,753f2380-99ac-4cc7-a751-9a6f86a18242,42787529,4354,2124,2124,0,50,112
386,753f2380-99ac-4cc7-a751-9a6f86a18242,42787529,4354,2238,2132,106,51,112
386,753f2380-99ac-4cc7-a751-9a6f86a18242,42787529,4354,2256,2247,9,52,112
386,753f2380-99ac-4cc7-a751-9a6f86a18242,42787529,4354,2369,2265,104,53,112
386,753f2380-99ac-4cc7-a751-9a6f86a18242,42787529,4354,2746,2371,375,56,112
386,753f2380-99ac-4cc7-a751-9a6f86a18242,42787529,4354,2941,2748,193,57,112
386,753f2380-99ac-4cc7-a751-9a6f86a18242,42787529,4354,2711,2140,-571,58,112
386,753f2380-99ac-4cc7-a751-9a6f86a18242,42787529,4354,2132,2110,-22,59,112
386,753f2380-99ac-4cc7-a751-9a6f86a18242,42787529,4354,2109,2109,0,60,112
386,753f2380-99ac-4cc7-a751-9a6f86a18242,42787529,4354,2068,1761,-307,77,112
386,753f2380-99ac-4cc7-a751-9a6f86a18242,42787529,4354,1762,1577,-185,78,112
386,753f2380-99ac-4cc7-a751-9a6f86a18242,42787529,4354,1570,1364,-206,79,112
386,753f2380-99ac-4cc7-a751-9a6f86a18242,42787529,4354,1360,1297,-63,80,112
386,753f2380-99ac-4cc7-a751-9a6f86a18242,42787529,4354,1288,1194,-94,82,112
386,753f2380-99ac-4cc7-a751-9a6f86a18242,42787529,4354,1193,1003,-190,83,112
386,753f2380-99ac-4cc7-a751-9a6f86a18242,42787529,4354,998,877,-121,84,112
386,753f2380-99ac-4cc7-a751-9a6f86a18242,42787529,4354,873,765,-108,85,112
386,753f2380-99ac-4cc7-a751-9a6f86a18242,42787529,4354,761,633,-128,86,112
386,753f2380-99ac-4cc7-a751-9a6f86a18242,42787529,4354,627,489,-138,87,112
386,753f2380-99ac-4cc7-a751-9a6f86a18242,42787529,4354,485,290,-195,88,112
386,753f2380-99ac-4cc7-a751-9a6f86a18242,42787529,4354,686,296,390,89,112
386,753f2380-99ac-4cc7-a751-9a6f86a18242,42787529,4354,945,691,254,90,112
386,753f2380-99ac-4cc7-a751-9a6f86a18242,42787529,4354,1182,952,230,91,112
386,753f2380-99ac-4cc7-a751-9a6f86a18242,42787529,4354,1350,1185,165,92,112
386,753f2380-99ac-4cc7-a751-9a6f86a18242,42787529,4354,1527,1364,163,93,112
386,753f2380-99ac-4cc7-a751-9a6f86a18242,42787529,4354,1607,1528,79,94,112
386,753f2380-99ac-4cc7-a751-9a6f86a18242,42787529,4354,1635,1609,26,95,112
386,753f2380-99ac-4cc7-a751-9a6f86a18242,42787529,4354,1787,1643,144,96,112
386,753f2380-99ac-4cc7-a751-9a6f86a18242,42787529,4354,1839,1789,50,97,112
386,753f2380-99ac-4cc7-a751-9a6f86a18242,42787529,4354,2514,1840,674,98,112
386,753f2380-99ac-4cc7-a751-9a6f86a18242,42787529,4354,3283,2517,766,99,112
386,753f2380-99ac-4cc7-a751-9a6f86a18242,42787529,4354,3299,3164,-135,100,112
386,753f2380-99ac-4cc7-a751-9a6f86a18242,42787529,4354,3247,3158,89,101,112
386,753f2380-99ac-4cc7-a751-9a6f86a18242,42787529,4354,3310,3248,62,102,112
386,753f2380-99ac-4cc7-a751-9a6f86a18242,42787529,4354,3308,3236,-72,103,112
386,753f2380-99ac-4cc7-a751-9a6f86a18242,42787529,4354,3434,3245,189,110,112
386,753f2380-99ac-4cc7-a751-9a6f86a18242,42787529,4354,3402,2878,-524,111,112
386,753f2380-99ac-4cc7-a751-9a6f86a18242,42787529,4354,2817,0,-2817,112,112
386,753f2380-99ac-4cc7-a751-9a6f86a18242,42787419,3338,497,5,492,0,39
386,753f2380-99ac-4cc7-a751-9a6f86a18242,42787419,3338,502,498,4,1,39
386,753f2380-99ac-4cc7-a751-9a6f86a18242,42787419,3338,1007,527,480,6,39
386,753f2380-99ac-4cc7-a751-9a6f86a18242,42787419,3338,977,848,-129,7,39
386,753f2380-99ac-4cc7-a751-9a6f86a18242,42787419,3338,847,836,-11,8,39
386,753f2380-99ac-4cc7-a751-9a6f86a18242,42787419,3338,1187,842,345,11,39
386,753f2380-99ac-4cc7-a751-9a6f86a18242,42787419,3338,1226,1188,38,12,39
386,753f2380-99ac-4cc7-a751-9a6f86a18242,42787419,3338,1312,1237,75,13,39
386,753f2380-99ac-4cc7-a751-9a6f86a18242,42787419,3338,1272,1251,21,14,39
386,753f2380-99ac-4cc7-a751-9a6f86a18242,42787419,3338,1275,1265,-10,15,39
386,753f2380-99ac-4cc7-a751-9a6f86a18242,42787419,3338,1264,1264,0,16,39
386,753f2380-99ac-4cc7-a751-9a6f86a18242,42787419,3338,1302,1267,35,18,39
386,753f2380-99ac-4cc7-a751-9a6f86a18242,42787419,3338,1408,1305,103,19,39
386,753f2380-99ac-4cc7-a751-9a6f86a18242,42787419,3338,1453,1409,44,20,39
386,753f2380-99ac-4cc7-a751-9a6f86a18242,42787419,3338,1503,1455,48,21,39
386,753f2380-99ac-4cc7-a751-9a6f86a18242,42787419,3338,1663,1512,151,22,39
386,753f2380-99ac-4cc7-a751-9a6f86a18242,42787419,3338,1716,1667,49,23,39
386,753f2380-99ac-4cc7-a751-9a6f86a18242,42787419,3338,1779,1718,61,24,39
386,753f2380-99ac-4cc7-a751-9a6f86a18242,42787419,3338,1747,1711,-36,25,39
386,753f2380-99ac-4cc7-a751-9a6f86a18242,42787419,3338,1904,1745,159,26,39
386,753f2380-99ac-4cc7-a751-9a6f86a18242,42787419,3338,1911,1906,5,27,39
386,753f2380-99ac-4cc7-a751-9a6f86a18242,42787419,3338,2043,1912,131,28,39
386,753f2380-99ac-4cc7-a751-9a6f86a18242,42787419,3338,2173,2047,126,29,39
386,753f2380-99ac-4cc7-a751-9a6f86a18242,42787419,3338,2125,2107,-18,30,39
386,753f2380-99ac-4cc7-a751-9a6f86a18242,42787419,3338,2285,2111,174,38,39
386,753f2380-99ac-4cc7-a751-9a6f86a18242,42787419,3338,2418,2290,128,39,39
384,9eb7c36e-6b18-475e-b9c9-43055cb03e19,42790624,10044,1044,20,1024,0,43
384,9eb7c36e-6b18-475e-b9c9-43055cb03e19,42790624,10044,1665,1045,620,1,43
384,9eb7c36e-6b18-475e-b9c9-43055cb03e19,42790624,10044,2692,1735,957,2,43
384,9eb7c36e-6b18-475e-b9c9-43055cb03e19,42790624,10044,4128,2737,1391,3,43
384,9eb7c36e-6b18-475e-b9c9-43055cb03e19,42790624,10044,4691,4153,538,4,43
384,9eb7c36e-6b18-475e-b9c9-43055cb03e19,42790624,10044,6465,4737,1728,17,43
384,9eb7c36e-6b18-475e-b9c9-43055cb03e19,42790624,10044,8481,6514,1967,18,43
384,9eb7c36e-6b18-475e-b9c9-43055cb03e19,42790624,10044,8387,6540,-1847,20,43
384,9eb7c36e-6b18-475e-b9c9-43055cb03e19,42790624,10044,6497,5897,-600,21,43
384,9eb7c36e-6b18-475e-b9c9-43055cb03e19,42790624,10044,5888,4598,-1290,22,43
384,9eb7c36e-6b18-475e-b9c9-43055cb03e19,42790624,10044,4495,572,-3923,23,43
384,9eb7c36e-6b18-475e-b9c9-43055cb03e19,42790624,10044,861,0,861,24,43
384,9eb7c36e-6b18-475e-b9c9-43055cb03e19,42790624,10044,1077,883,194,25,43
384,9eb7c36e-6b18-475e-b9c9-43055cb03e19,42790624,10044,1418,1087,331,39,43
384,9eb7c36e-6b18-475e-b9c9-43055cb03e19,42790624,10044,2037,1442,595,40,43
384,9eb7c36e-6b18-475e-b9c9-43055cb03e19,42790624,10044,3106,2044,1062,41,43
384,9eb7c36e-6b18-475e-b9c9-43055cb03e19,42790624,10044,3108,2545,-563,42,43
384,9eb7c36e-6b18-475e-b9c9-43055cb03e19,42790624,10044,3012,2524,488,43,43
385,2c9c06d9-eddf-46a9-bc19-bf55b4f241aa,42800271,9129,844,22,822,0,11
385,2c9c06d9-eddf-46a9-bc19-bf55b4f241aa,42800271,9129,868,849,19,1,11
385,2c9c06d9-eddf-46a9-bc19-bf55b4f241aa,42800271,9129,1308,903,405,7,11
385,2c9c06d9-eddf-46a9-bc19-bf55b4f241aa,42800271,9129,1552,1337,215,8,11
385,2c9c06d9-eddf-46a9-bc19-bf55b4f241aa,42800271,9129,2004,1568,436,11,11
385,2c9c06d9-eddf-46a9-bc19-bf55b4f241aa,42799284,7473,675,25,650,0,34
385,2c9c06d9-eddf-46a9-bc19-bf55b4f241aa,42799284,7473,1233,702,531,10,34
385,2c9c06d9-eddf-46a9-bc19-bf55b4f241aa,42799284,7473,2140,1248,892,18,34
385,2c9c06d9-eddf-46a9-bc19-bf55b4f241aa,42799284,7473,2591,2174,417,24,34
385,2c9c06d9-eddf-46a9-bc19-bf55b4f241aa,42799284,7473,2955,2612,343,30,34
385,2c9c06d9-eddf-46a9-bc19-bf55b4f241aa,42799284,7473,3028,2973,55,31,34
385,2c9c06d9-eddf-46a9-bc19-bf55b4f241aa,42799284,7473,3947,3111,836,33,34
385,2c9c06d9-eddf-46a9-bc19-bf55b4f241aa,42799284,7473,3934,3921,-13,34,34
385,2c9c06d9-eddf-46a9-bc19-bf55b4f241aa,42787529,4803,229,1,228,0,4
385,2c9c06d9-eddf-46a9-bc19-bf55b4f241aa,42787529,5412,601,258,343,3,4
385,2c9c06d9-eddf-46a9-bc19-bf55b4f241aa,42787529,5412,1167,671,496,4,4
387,cc984e33-479e-4477-9671-0b590114475d,42803812,11419,1003,2,1001,0,9512
387,cc984e33-479e-4477-9671-0b590114475d,42803812,11419,2560,1029,1531,1,9512
387,cc984e33-479e-4477-9671-0b590114475d,42803812,11419,4680,2587,2093,2,9512
387,cc984e33-479e-4477-9671-0b590114475d,42803812,11419,4951,4704,247,3,9512
387,cc984e33-479e-4477-9671-0b590114475d,42803812,11419,4969,4969,0,9509,9512
387,cc984e33-479e-4477-9671-0b590114475d,42803812,11419,5109,4977,132,9510,9512
387,cc984e33-479e-4477-9671-0b590114475d,42803812,11419,7062,5142,1920,9511,9512
387,cc984e33-479e-4477-9671-0b590114475d,42803812,11419,7890,7120,770,9512,9512
391,d1b124e0-ae0d-452b-aa8a-17f409f5c686,42805482,5841,1310,11,1299,0,2
391,d1b124e0-ae0d-452b-aa8a-17f409f5c686,42805482,5841,4461,1314,3147,1,2
391,d1b124e0-ae0d-452b-aa8a-17f409f5c686,42805482,5841,4268,0,-4268,2,2
390,7de36bfb-7329-410a-a618-ec862a03accd,42810724,24996,257,2,255,0,14
390,7de36bfb-7329-410a-a618-ec862a03accd,42810724,24996,266,260,6,1,14
390,7de36bfb-7329-410a-a618-ec862a03accd,42810724,24996,1627,278,1349,2,14
390,7de36bfb-7329-410a-a618-ec862a03accd,42810724,24996,3246,1630,1616,3,14
390,7de36bfb-7329-410a-a618-ec862a03accd,42810724,24996,3929,3248,681,4,14
390,7de36bfb-7329-410a-a618-ec862a03accd,42810724,24996,7223,4052,3171,5,14
390,7de36bfb-7329-410a-a618-ec862a03accd,42810724,24996,8478,7257,1221,6,14
390,7de36bfb-7329-410a-a618-ec862a03accd,42810724,24996,12423,8485,3938,7,14
390,7de36bfb-7329-410a-a618-ec862a03accd,42810724,24996,19942,12484,7458,8,14
390,7de36bfb-7329-410a-a618-ec862a03accd,42810724,24996,23616,20080,3536,9,14
390,7de36bfb-7329-410a-a618-ec862a03accd,42810724,1380,0,0,0,14,14
390,7de36bfb-7329-410a-a618-ec862a03accd,42809865,4410,472,54,418,0,1
390,7de36bfb-7329-410a-a618-ec862a03accd,42809865,4410,1871,573,1298,1,1
390,17a10ba1-03be-4756-8c50-0e2cf0c4ec10,42810724,24996,3819,1,3818,0,5
390,17a10ba1-03be-4756-8c50-0e2cf0c4ec10,42810724,24996,11265,3847,7418,1,5
390,17a10ba1-03be-4756-8c50-0e2cf0c4ec10,42810724,24996,17819,11384,6435,2,5
390,17a10ba1-03be-4756-8c50-0e2cf0c4ec10,42810724,24996,23616,17874,5742,3,5
390,17a10ba1-03be-4756-8c50-0e2cf0c4ec10,42810724,24996,23529,21738,-1791,4,5
390,17a10ba1-03be-4756-8c50-0e2cf0c4ec10,42810724,24996,21613,18927,-2686,5,5
390,17a10ba1-03be-4756-8c50-0e2cf0c4ec10,42811433,4617,1374,27,1347,0,4
390,17a10ba1-03be-4756-8c50-0e2cf0c4ec10,42811433,4617,3237,1426,1811,1,4
390,17a10ba1-03be-4756-8c50-0e2cf0c4ec10,42811433,4617,3232,2784,-448,2,4
390,17a10ba1-03be-4756-8c50-0e2cf0c4ec10,42811433,4617,2749,993,-1756,3,4
390,17a10ba1-03be-4756-8c50-0e2cf0c4ec10,42811433,4617,962,619,-343,4,4
390,f5ab7dff-d63e-474a-b69b-f1c66ae5be10,42805712,6432,1608,11,1597,0,14
390,f5ab7dff-d63e-474a-b69b-f1c66ae5be10,42805712,6432,3697,1649,2048,1,14
390,f5ab7dff-d63e-474a-b69b-f1c66ae5be10,42805712,6432,5052,3698,1354,2,14
390,f5ab7dff-d63e-474a-b69b-f1c66ae5be10,42805712,6432,4893,4734,-159,3,14
390,f5ab7dff-d63e-474a-b69b-f1c66ae5be10,42805712,6432,4610,878,-3732,4,14
390,f5ab7dff-d63e-474a-b69b-f1c66ae5be10,42805712,6432,844,0,-844,5,14
390,f5ab7dff-d63e-474a-b69b-f1c66ae5be10,42805712,6432,81,2,79,6,14
390,f5ab7dff-d63e-474a-b69b-f1c66ae5be10,42805712,6432,341,82,259,7,14
390,f5ab7dff-d63e-474a-b69b-f1c66ae5be10,42805712,6432,878,342,536,8,14
390,f5ab7dff-d63e-474a-b69b-f1c66ae5be10,42805712,6432,2780,889,1891,9,14
390,f5ab7dff-d63e-474a-b69b-f1c66ae5be10,42805712,6432,4145,2797,1348,10,14
390,f5ab7dff-d63e-474a-b69b-f1c66ae5be10,42805712,6432,5052,4178,874,11,14
390,f5ab7dff-d63e-474a-b69b-f1c66ae5be10,42805712,6432,5032,4230,-802,12,14
390,f5ab7dff-d63e-474a-b69b-f1c66ae5be10,42805712,6432,4144,709,-3435,13,14
390,f5ab7dff-d63e-474a-b69b-f1c66ae5be10,42805712,6432,676,0,-676,14,14
390,f5ab7dff-d63e-474a-b69b-f1c66ae5be10,42810724,24996,179,3,176,0,18
390,f5ab7dff-d63e-474a-b69b-f1c66ae5be10,42810724,24996,373,180,193,1,18
390,f5ab7dff-d63e-474a-b69b-f1c66ae5be10,42810724,24996,1319,378,941,2,18
390,f5ab7dff-d63e-474a-b69b-f1c66ae5be10,42810724,24996,3392,1340,2052,3,18
390,f5ab7dff-d63e-474a-b69b-f1c66ae5be10,42810724,24996,6092,3510,2582,4,18
390,f5ab7dff-d63e-474a-b69b-f1c66ae5be10,42810724,24996,9561,6147,3414,5,18
390,f5ab7dff-d63e-474a-b69b-f1c66ae5be10,42810724,24996,16294,9586,6708,6,18
390,f5ab7dff-d63e-474a-b69b-f1c66ae5be10,42810724,24996,21526,16398,5128,7,18
390,f5ab7dff-d63e-474a-b69b-f1c66ae5be10,42810724,24996,23616,21730,1886,8,18
390,f5ab7dff-d63e-474a-b69b-f1c66ae5be10,42810724,24996,22770,22295,-475,9,18
390,f5ab7dff-d63e-474a-b69b-f1c66ae5be10,42810724,24996,22252,21446,-806,10,18
390,f5ab7dff-d63e-474a-b69b-f1c66ae5be10,42810724,24996,21442,21343,-99,11,18
390,f5ab7dff-d63e-474a-b69b-f1c66ae5be10,42810724,24996,21342,20579,-763,12,18
390,f5ab7dff-d63e-474a-b69b-f1c66ae5be10,42810724,24996,20565,20159,-406,13,18
390,f5ab7dff-d63e-474a-b69b-f1c66ae5be10,42810724,24996,20839,20182,-657,14,18
390,f5ab7dff-d63e-474a-b69b-f1c66ae5be10,42810724,24996,20422,19628,794,15,18
390,f5ab7dff-d63e-474a-b69b-f1c66ae5be10,42810724,24996,21085,20163,-922,16,18
390,f5ab7dff-d63e-474a-b69b-f1c66ae5be10,42810724,24996,21407,20020,1387,17,18
390,f5ab7dff-d63e-474a-b69b-f1c66ae5be10,42810724,24996,21731,21050,-681,18,18
389,98255014-39d5-42a5-a5de-7494ec313ee7,42812158,5262,164,2,162,0,14629
389,98255014-39d5-42a5-a5de-7494ec313ee7,42812158,5262,226,172,54,1,14629
389,98255014-39d5-42a5-a5de-7494ec313ee7,42812158,5262,654,240,414,7,14629
389,98255014-39d5-42a5-a5de-7494ec313ee7,42812158,5262,722,666,56,8,14629
389,98255014-39d5-42a5-a5de-7494ec313ee7,42812158,5262,863,723,140,17,14629
389,98255014-39d5-42a5-a5de-7494ec313ee7,42812158,5262,942,870,72,18,14629
389,98255014-39d5-42a5-a5de-7494ec313ee7,42812158,5262,1082,950,132,25,14629
389,98255014-39d5-42a5-a5de-7494ec313ee7,42812158,5262,1084,1083,1,26,14629
389,98255014-39d5-42a5-a5de-7494ec313ee7,42812158,5262,1157,1085,72,31,14629
389,98255014-39d5-42a5-a5de-7494ec313ee7,42812158,5262,1174,1161,13,32,14629
389,98255014-39d5-42a5-a5de-7494ec313ee7,42812158,5262,1179,1179,0,36,14629
389,98255014-39d5-42a5-a5de-7494ec313ee7,42812158,5262,1290,1187,103,37,14629
389,98255014-39d5-42a5-a5de-7494ec313ee7,42812158,5262,1304,1292,12,38,14629
389,98255014-39d5-42a5-a5de-7494ec313ee7,42812158,5262,1306,1305,1,39,14629
389,98255014-39d5-42a5-a5de-7494ec313ee7,42812158,5262,1306,1305,-1,39,14629
389,98255014-39d5-42a5-a5de-7494ec313ee7,42812158,5262,1462,1308,154,53,14629
389,98255014-39d5-42a5-a5de-7494ec313ee7,42812158,5262,1558,1468,90,54,14629
389,98255014-39d5-42a5-a5de-7494ec313ee7,42812158,5262,1692,1566,126,55,14629
389,98255014-39d5-42a5-a5de-7494ec313ee7,42812158,5262,1780,1693,87,56,14629
389,98255014-39d5-42a5-a5de-7494ec313ee7,42812158,5262,1933,1790,143,57,14629
389,98255014-39d5-42a5-a5de-7494ec313ee7,42812158,5262,2008,1935,73,58,14629
389,98255014-39d5-42a5-a5de-7494ec313ee7,42812158,5262,2061,2009,52,59,14629
389,98255014-39d5-42a5-a5de-7494ec313ee7,42812158,5262,2131,2062,69,60,14629
389,98255014-39d5-42a5-a5de-7494ec313ee7,42812158,5262,2135,2132,3,61,14629
389,98255014-39d5-42a5-a5de-7494ec313ee7,42812158,5262,2293,2139,154,86,14629
389,98255014-39d5-42a5-a5de-7494ec313ee7,42812158,5262,2604,2297,307,107,14629
389,98255014-39d5-42a5-a5de-7494ec313ee7,42812158,5262,2788,2613,175,108,14629
389,98255014-39d5-42a5-a5de-7494ec313ee7,42812158,5262,2825,2789,36,109,14629
389,98255014-39d5-42a5-a5de-7494ec313ee7,42812158,5262,3115,2839,276,125,14629
389,98255014-39d5-42a5-a5de-7494ec313ee7,42812158,5262,3117,3116,-1,126,14629
389,98255014-39d5-42a5-a5de-7494ec313ee7,42812158,5262,3466,3118,348,152,14629
389,98255014-39d5-42a5-a5de-7494ec313ee7,42812158,5262,3501,3468,33,153,14629
389,98255014-39d5-42a5-a5de-7494ec313ee7,42812158,5262,3509,3509,0,162,14629
389,98255014-39d5-42a5-a5de-7494ec313ee7,42812158,5262,3689,3522,167,163,14629
389,98255014-39d5-42a5-a5de-7494ec313ee7,42812158,5262,3656,2752,-904,14626,14629
389,98255014-39d5-42a5-a5de-7494ec313ee7,42812158,5262,2690,1587,-1103,14627,14629
389,98255014-39d5-42a5-a5de-7494ec313ee7,42812158,5262,1586,1566,-20,14628,14629
389,98255014-39d5-42a5-a5de-7494ec313ee7,42812158,5262,1567,1567,0,14629,14629
385,98f10109-a707-4dc0-a65f-ed55a0f4e5f4,42827210,7776,751,30,721,0,46
385,98f10109-a707-4dc0-a65f-ed55a0f4e5f4,42827210,7776,971,766,205,6,46
385,98f10109-a707-4dc0-a65f-ed55a0f4e5f4,42827210,7776,2145,984,1161,13,46
385,98f10109-a707-4dc0-a65f-ed55a0f4e5f4,42827210,7776,2173,2151,22,14,46
385,98f10109-a707-4dc0-a65f-ed55a0f4e5f4,42827210,7776,2343,2190,153,18,46
385,98f10109-a707-4dc0-a65f-ed55a0f4e5f4,42827210,7776,2826,2374,452,34,46
385,98f10109-a707-4dc0-a65f-ed55a0f4e5f4,42827210,7776,3334,2842,492,37,46
385,98f10109-a707-4dc0-a65f-ed55a0f4e5f4,42827210,7776,3338,3336,2,38,46
385,98f10109-a707-4dc0-a65f-ed55a0f4e5f4,42827210,7776,3868,3372,496,43,46
385,98f10109-a707-4dc0-a65f-ed55a0f4e5f4,42827210,7776,4280,3875,405,46,46
385,98f10109-a707-4dc0-a65f-ed55a0f4e5f4,42825431,9972,394,18,376,0,56
385,98f10109-a707-4dc0-a65f-ed55a0f4e5f4,42825431,9972,687,436,251,1,56
385,98f10109-a707-4dc0-a65f-ed55a0f4e5f4,42825431,9972,879,724,155,13,56
385,98f10109-a707-4dc0-a65f-ed55a0f4e5f4,42825431,9972,975,890,85,14,56
385,98f10109-a707-4dc0-a65f-ed55a0f4e5f4,42825431,9972,1113,1021,92,17,56
385,98f10109-a707-4dc0-a65f-ed55a0f4e5f4,42825431,9972,1447,1172,275,18,56
385,98f10109-a707-4dc0-a65f-ed55a0f4e5f4,42825431,9972,1555,1502,53,24,56
385,98f10109-a707-4dc0-a65f-ed55a0f4e5f4,42825431,9972,2132,1606,526,25,56
385,98f10109-a707-4dc0-a65f-ed55a0f4e5f4,42825431,9972,2657,2161,496,34,56
385,98f10109-a707-4dc0-a65f-ed55a0f4e5f4,42825431,9972,3752,2675,1077,38,56
385,98f10109-a707-4dc0-a65f-ed55a0f4e5f4,42825431,9972,3844,3778,66,39,56
385,98f10109-a707-4dc0-a65f-ed55a0f4e5f4,42825431,9972,3870,3870,0,54,56
385,98f10109-a707-4dc0-a65f-ed55a0f4e5f4,42825431,9972,5179,3909,1270,55,56
385,98f10109-a707-4dc0-a65f-ed55a0f4e5f4,42825431,9972,5419,5197,222,56,56
385,98f10109-a707-4dc0-a65f-ed55a0f4e5f4,42826028,4449,68,28,40,0,41
385,98f10109-a707-4dc0-a65f-ed55a0f4e5f4,42826028,4449,433,0,-433,1,41
385,98f10109-a707-4dc0-a65f-ed55a0f4e5f4,42826028,4449,612,18,594,2,41
385,98f10109-a707-4dc0-a65f-ed55a0f4e5f4,42826028,4449,836,633,203,8,41
385,98f10109-a707-4dc0-a65f-ed55a0f4e5f4,42826028,4449,1146,859,287,11,41
385,98f10109-a707-4dc0-a65f-ed55a0f4e5f4,42826028,4449,1480,1161,319,16,41
385,98f10109-a707-4dc0-a65f-ed55a0f4e5f4,42826028,4449,1796,1501,295,21,41
385,98f10109-a707-4dc0-a65f-ed55a0f4e5f4,42826028,4449,1943,1808,135,22,41
385,98f10109-a707-4dc0-a65f-ed55a0f4e5f4,42826028,4449,2192,1986,206,23,41
385,98f10109-a707-4dc0-a65f-ed55a0f4e5f4,42826028,4449,2167,1748,-419,27,41
385,98f10109-a707-4dc0-a65f-ed55a0f4e5f4,42826028,4449,2437,1781,656,28,41
385,98f10109-a707-4dc0-a65f-ed55a0f4e5f4,42826028,4449,2649,2443,206,30,41
385,98f10109-a707-4dc0-a65f-ed55a0f4e5f4,42826028,4449,2650,2650,0,31,41
385,98f10109-a707-4dc0-a65f-ed55a0f4e5f4,42826028,4449,2925,2693,232,41,41
385,98f10109-a707-4dc0-a65f-ed55a0f4e5f4,42826915,6276,74,35,39,0,13
385,98f10109-a707-4dc0-a65f-ed55a0f4e5f4,42826915,6276,916,120,796,1,13
385,98f10109-a707-4dc0-a65f-ed55a0f4e5f4,42826915,6276,1574,947,627,12,13
385,98f10109-a707-4dc0-a65f-ed55a0f4e5f4,42826915,6276,1785,1602,183,13,13
385,98f10109-a707-4dc0-a65f-ed55a0f4e5f4,42821938,5625,1027,24,1003,0,30
385,98f10109-a707-4dc0-a65f-ed55a0f4e5f4,42821938,5625,1397,980,-417,1,30
385,98f10109-a707-4dc0-a65f-ed55a0f4e5f4,42821938,5625,1486,1022,464,16,30
385,98f10109-a707-4dc0-a65f-ed55a0f4e5f4,42821938,5625,1854,1515,339,20,30
385,98f10109-a707-4dc0-a65f-ed55a0f4e5f4,42821938,5625,2253,1874,379,28,30
385,98f10109-a707-4dc0-a65f-ed55a0f4e5f4,42821938,5625,3317,2295,1022,29,30
385,98f10109-a707-4dc0-a65f-ed55a0f4e5f4,42821938,5625,3804,3359,445,30,30
385,98f10109-a707-4dc0-a65f-ed55a0f4e5f4,42820246,5655,85,47,38,0,70
385,98f10109-a707-4dc0-a65f-ed55a0f4e5f4,42820246,5655,685,125,560,1,70
385,98f10109-a707-4dc0-a65f-ed55a0f4e5f4,42820246,5655,863,693,170,20,70
385,98f10109-a707-4dc0-a65f-ed55a0f4e5f4,42820246,5655,1360,879,481,35,70
385,98f10109-a707-4dc0-a65f-ed55a0f4e5f4,42820246,5655,1608,1391,217,40,70
385,98f10109-a707-4dc0-a65f-ed55a0f4e5f4,42820246,5655,1810,1642,168,41,70
385,98f10109-a707-4dc0-a65f-ed55a0f4e5f4,42820246,5655,2482,1835,647,45,70
385,98f10109-a707-4dc0-a65f-ed55a0f4e5f4,42820246,5655,2507,2488,19,46,70
385,98f10109-a707-4dc0-a65f-ed55a0f4e5f4,42820246,5655,2962,2513,449,49,70
385,98f10109-a707-4dc0-a65f-ed55a0f4e5f4,42820246,5655,3748,2971,777,69,70
385,98f10109-a707-4dc0-a65f-ed55a0f4e5f4,42820246,5655,4131,3749,382,70,70
389,98255014-39d5-42a5-a5de-7494ec313ee7,42819405,5766,282,10,272,0,109
389,98255014-39d5-42a5-a5de-7494ec313ee7,42819405,5766,288,284,4,1,109
389,98255014-39d5-42a5-a5de-7494ec313ee7,42819405,5766,656,311,345,87,109
389,98255014-39d5-42a5-a5de-7494ec313ee7,42819405,5766,856,661,195,88,109
389,98255014-39d5-42a5-a5de-7494ec313ee7,42819405,5766,873,858,15,89,109
389,98255014-39d5-42a5-a5de-7494ec313ee7,42819405,5766,871,871,0,90,109
389,98255014-39d5-42a5-a5de-7494ec313ee7,42819405,5766,934,872,62,91,109
389,98255014-39d5-42a5-a5de-7494ec313ee7,42819405,5766,1004,940,64,92,109
389,98255014-39d5-42a5-a5de-7494ec313ee7,42819405,5766,1008,1005,3,93,109
389,98255014-39d5-42a5-a5de-7494ec313ee7,42819405,5766,1042,1009,33,94,109
389,98255014-39d5-42a5-a5de-7494ec313ee7,42819405,5766,1064,1041,23,95,109
389,98255014-39d5-42a5-a5de-7494ec313ee7,42819405,5766,1103,1065,38,96,109
389,98255014-39d5-42a5-a5de-7494ec313ee7,42819405,5766,1106,1104,2,97,109
389,98255014-39d5-42a5-a5de-7494ec313ee7,42819405,5766,1117,1107,10,98,109
389,98255014-39d5-42a5-a5de-7494ec313ee7,42819405,5766,1151,1118,33,99,109
389,98255014-39d5-42a5-a5de-7494ec313ee7,42819405,5766,1235,1153,82,100,109
389,98255014-39d5-42a5-a5de-7494ec313ee7,42819405,5766,1489,1236,253,107,109
389,98255014-39d5-42a5-a5de-7494ec313ee7,42819405,5766,2076,1490,586,108,109
389,98255014-39d5-42a5-a5de-7494ec313ee7,42819405,5766,2054,1894,-160,109,109
389,59fee2e6-e8d2-462f-991d-139820ab7970,42831507,3046,134,16,118,0,93
389,59fee2e6-e8d2-462f-991d-139820ab7970,42831507,3046,375,151,224,1,93
389,59fee2e6-e8d2-462f-991d-139820ab7970,42831507,3046,536,383,153,2,93
389,59fee2e6-e8d2-462f-991d-139820ab7970,42831507,3046,579,546,33,27,93
389,59fee2e6-e8d2-462f-991d-139820ab7970,42831507,3046,743,593,150,28,93
389,59fee2e6-e8d2-462f-991d-139820ab7970,42831507,3046,761,744,17,29,93
389,59fee2e6-e8d2-462f-991d-139820ab7970,42831507,3046,764,763,1,30,93
389,59fee2e6-e8d2-462f-991d-139820ab7970,42831507,3046,767,765,2,32,93
389,59fee2e6-e8d2-462f-991d-139820ab7970,42831507,3046,796,768,28,52,93
389,59fee2e6-e8d2-462f-991d-139820ab7970,42831507,3046,883,804,79,54,93
389,59fee2e6-e8d2-462f-991d-139820ab7970,42831507,3046,877,736,-141,55,93
389,59fee2e6-e8d2-462f-991d-139820ab7970,42831507,3046,803,741,62,62,93
389,59fee2e6-e8d2-462f-991d-139820ab7970,42831507,3046,804,804,0,66,93
389,59fee2e6-e8d2-462f-991d-139820ab7970,42831507,3046,811,802,9,67,93
389,59fee2e6-e8d2-462f-991d-139820ab7970,42831507,3046,876,812,64,68,93
389,59fee2e6-e8d2-462f-991d-139820ab7970,42831507,3046,875,874,1,69,93
389,59fee2e6-e8d2-462f-991d-139820ab7970,42831507,3046,1240,877,363,92,93
389,59fee2e6-e8d2-462f-991d-139820ab7970,42831507,3046,1458,1257,201,93,93
389,318570ab-c3c5-4393-bf0c-40a5cecc1e74,42826915,4385,229,23,206,0,0
389,318570ab-c3c5-4393-bf0c-40a5cecc1e74,42821938,3902,752,21,731,0,0
389,90e17a0c-329b-4af7-9fe3-237c6b01bbf5,42851668,6705,190,13,177,0,98954
389,90e17a0c-329b-4af7-9fe3-237c6b01bbf5,42851668,6705,324,211,113,1,98954
389,90e17a0c-329b-4af7-9fe3-237c6b01bbf5,42851668,6705,572,323,249,2,98954
389,90e17a0c-329b-4af7-9fe3-237c6b01bbf5,42851668,6705,617,573,44,3,98954
389,90e17a0c-329b-4af7-9fe3-237c6b01bbf5,42851668,6705,653,620,33,4,98954
389,90e17a0c-329b-4af7-9fe3-237c6b01bbf5,42851668,6705,673,654,19,5,98954
389,90e17a0c-329b-4af7-9fe3-237c6b01bbf5,42851668,6705,755,674,81,6,98954
389,90e17a0c-329b-4af7-9fe3-237c6b01bbf5,42851668,6705,836,763,73,7,98954
389,90e17a0c-329b-4af7-9fe3-237c6b01bbf5,42851668,6705,843,837,6,8,98954
389,90e17a0c-329b-4af7-9fe3-237c6b01bbf5,42851668,6705,856,844,12,9,98954
389,90e17a0c-329b-4af7-9fe3-237c6b01bbf5,42851668,6705,883,857,26,10,98954
389,90e17a0c-329b-4af7-9fe3-237c6b01bbf5,42851668,6705,899,884,15,11,98954
389,90e17a0c-329b-4af7-9fe3-237c6b01bbf5,42851668,6705,996,900,96,12,98954
389,90e17a0c-329b-4af7-9fe3-237c6b01bbf5,42851668,6705,998,996,-2,13,98954
389,90e17a0c-329b-4af7-9fe3-237c6b01bbf5,42851668,6705,916,0,-916,98954,98954
401,9848fff2-7044-40f2-bc9c-123f4b0f9873,43439807,13683,202,14,188,0,150
401,9848fff2-7044-40f2-bc9c-123f4b0f9873,43439807,13683,470,214,256,1,150
401,9848fff2-7044-40f2-bc9c-123f4b0f9873,43439807,13683,716,479,237,9,150
401,9848fff2-7044-40f2-bc9c-123f4b0f9873,43439807,13683,754,722,32,10,150
401,9848fff2-7044-40f2-bc9c-123f4b0f9873,43439807,13683,1171,779,392,17,150
401,9848fff2-7044-40f2-bc9c-123f4b0f9873,43439807,13683,1193,1173,20,18,150
401,9848fff2-7044-40f2-bc9c-123f4b0f9873,43439807,13683,1552,1205,347,27,150
401,9848fff2-7044-40f2-bc9c-123f4b0f9873,43439807,13683,1577,1555,22,28,150
401,9848fff2-7044-40f2-bc9c-123f4b0f9873,43439807,13683,1999,1580,419,30,150
401,9848fff2-7044-40f2-bc9c-123f4b0f9873,43439807,13683,2428,2009,419,40,150
401,9848fff2-7044-40f2-bc9c-123f4b0f9873,43439807,13683,2951,2449,502,50,150
401,9848fff2-7044-40f2-bc9c-123f4b0f9873,43439807,13683,3644,2965,679,55,150
401,9848fff2-7044-40f2-bc9c-123f4b0f9873,43439807,13683,4080,3665,415,57,150
401,9848fff2-7044-40f2-bc9c-123f4b0f9873,43439807,13683,4168,4095,73,58,150
401,9848fff2-7044-40f2-bc9c-123f4b0f9873,43439807,13683,4657,4191,466,66,150
401,9848fff2-7044-40f2-bc9c-123f4b0f9873,43439807,13683,4726,4667,59,67,150
401,9848fff2-7044-40f2-bc9c-123f4b0f9873,43439807,13683,5140,4735,405,80,150
401,9848fff2-7044-40f2-bc9c-123f4b0f9873,43439807,13683,5306,5152,154,81,150
401,9848fff2-7044-40f2-bc9c-123f4b0f9873,43439807,13683,5984,5323,661,91,150
401,9848fff2-7044-40f2-bc9c-123f4b0f9873,43439807,13683,6637,6006,631,98,150
401,9848fff2-7044-40f2-bc9c-123f4b0f9873,43439807,13683,6642,6639,3,99,150
401,9848fff2-7044-40f2-bc9c-123f4b0f9873,43439807,13683,7120,6655,465,100,150
401,9848fff2-7044-40f2-bc9c-123f4b0f9873,43439807,13683,7775,7136,639,129,150
401,9848fff2-7044-40f2-bc9c-123f4b0f9873,43439807,13683,7936,7800,136,130,150
401,9848fff2-7044-40f2-bc9c-123f4b0f9873,43439807,13683,8397,7958,439,142,150
401,9848fff2-7044-40f2-bc9c-123f4b0f9873,43439807,13683,9238,8452,786,143,150
401,9848fff2-7044-40f2-bc9c-123f4b0f9873,43439807,13683,9684,9255,429,149,150
401,9848fff2-7044-40f2-bc9c-123f4b0f9873,43439807,13683,9834,9708,126,150,150
401,9848fff2-7044-40f2-bc9c-123f4b0f9873,43444791,7425,207,13,194,0,160
401,9848fff2-7044-40f2-bc9c-123f4b0f9873,43444791,7425,724,221,503,1,160
401,9848fff2-7044-40f2-bc9c-123f4b0f9873,43444791,7425,768,730,38,2,160
401,9848fff2-7044-40f2-bc9c-123f4b0f9873,43444791,7425,932,769,163,21,160
401,9848fff2-7044-40f2-bc9c-123f4b0f9873,43444791,7425,1474,951,523,22,160
401,9848fff2-7044-40f2-bc9c-123f4b0f9873,43444791,7425,1998,1511,487,41,160
401,9848fff2-7044-40f2-bc9c-123f4b0f9873,43444791,7425,2246,2004,242,48,160
401,9848fff2-7044-40f2-bc9c-123f4b0f9873,43444791,7425,2393,2269,124,49,160
401,9848fff2-7044-40f2-bc9c-123f4b0f9873,43444791,7425,2600,2423,177,55,160
401,9848fff2-7044-40f2-bc9c-123f4b0f9873,43444791,7425,3067,2619,448,56,160
401,9848fff2-7044-40f2-bc9c-123f4b0f9873,43444791,7425,3608,3107,501,84,160
401,9848fff2-7044-40f2-bc9c-123f4b0f9873,43444791,7425,3615,3611,4,85,160
401,9848fff2-7044-40f2-bc9c-123f4b0f9873,43444791,7425,4001,3619,382,102,160
401,9848fff2-7044-40f2-bc9c-123f4b0f9873,43444791,7425,4083,4013,70,103,160
401,9848fff2-7044-40f2-bc9c-123f4b0f9873,43444791,7425,4419,4092,327,121,160
401,9848fff2-7044-40f2-bc9c-123f4b0f9873,43444791,7425,4489,4426,63,122,160
401,9848fff2-7044-40f2-bc9c-123f4b0f9873,43444791,7425,4989,4505,484,131,160
401,9848fff2-7044-40f2-bc9c-123f4b0f9873,43444791,7425,5501,5008,493,142,160
401,9848fff2-7044-40f2-bc9c-123f4b0f9873,43444791,7425,5641,5524,117,159,160
401,9848fff2-7044-40f2-bc9c-123f4b0f9873,43444791,7425,5901,5679,222,160,160
401,9848fff2-7044-40f2-bc9c-123f4b0f9873,43428003,2955,382,42,340,0,44
401,9848fff2-7044-40f2-bc9c-123f4b0f9873,43428003,2955,560,403,157,1,44
401,9848fff2-7044-40f2-bc9c-123f4b0f9873,43428003,2955,879,565,314,21,44
401,9848fff2-7044-40f2-bc9c-123f4b0f9873,43428003,2955,1318,889,429,26,44
401,9848fff2-7044-40f2-bc9c-123f4b0f9873,43428003,2955,1431,1354,77,44,44
401,9848fff2-7044-40f2-bc9c-123f4b0f9873,43429393,7341,470,23,447,0,105
401,9848fff2-7044-40f2-bc9c-123f4b0f9873,43429393,7341,1000,509,491,9,105
401,9848fff2-7044-40f2-bc9c-123f4b0f9873,43429393,7341,1004,1002,2,10,105
401,9848fff2-7044-40f2-bc9c-123f4b0f9873,43429393,7341,1706,1016,690,18,105
401,9848fff2-7044-40f2-bc9c-123f4b0f9873,43429393,7341,1900,1709,191,29,105
401,9848fff2-7044-40f2-bc9c-123f4b0f9873,43429393,7341,2034,1913,121,30,105
401,9848fff2-7044-40f2-bc9c-123f4b0f9873,43429393,7341,2461,2052,409,35,105
401,9848fff2-7044-40f2-bc9c-123f4b0f9873,43429393,7341,2591,2481,110,50,105
401,9848fff2-7044-40f2-bc9c-123f4b0f9873,43429393,7341,3169,2610,559,51,105
401,9848fff2-7044-40f2-bc9c-123f4b0f9873,43429393,7341,3624,3187,437,57,105
401,9848fff2-7044-40f2-bc9c-123f4b0f9873,43429393,7341,4103,3628,475,70,105
401,9848fff2-7044-40f2-bc9c-123f4b0f9873,43429393,7341,4149,4111,38,71,105
401,9848fff2-7044-40f2-bc9c-123f4b0f9873,43429393,7341,4618,4181,437,82,105
401,9848fff2-7044-40f2-bc9c-123f4b0f9873,43429393,7341,4716,4633,83,83,105
401,9848fff2-7044-40f2-bc9c-123f4b0f9873,43429393,7341,5136,4755,381,94,105
401,9848fff2-7044-40f2-bc9c-123f4b0f9873,43429393,7341,5382,5144,238,95,105
401,9848fff2-7044-40f2-bc9c-123f4b0f9873,43429393,7341,5817,5415,402,105,105
401,2c8edaba-2387-4a58-bd43-2ef1b3e09139,43446359,5469,151,6,145,0,81
401,2c8edaba-2387-4a58-bd43-2ef1b3e09139,43446359,5469,818,175,643,1,81
401,2c8edaba-2387-4a58-bd43-2ef1b3e09139,43446359,5469,860,820,40,2,81
401,2c8edaba-2387-4a58-bd43-2ef1b3e09139,43446359,5469,1717,861,856,18,81
401,2c8edaba-2387-4a58-bd43-2ef1b3e09139,43446359,5469,1763,1718,45,19,81
401,2c8edaba-2387-4a58-bd43-2ef1b3e09139,43446359,5469,2440,1768,672,41,81
401,2c8edaba-2387-4a58-bd43-2ef1b3e09139,43446359,5469,2520,2451,69,42,81
401,2c8edaba-2387-4a58-bd43-2ef1b3e09139,43446359,5469,2736,2526,210,65,81
401,2c8edaba-2387-4a58-bd43-2ef1b3e09139,43446359,5469,3312,2759,553,66,81
401,2c8edaba-2387-4a58-bd43-2ef1b3e09139,43446359,5469,3890,3320,570,80,81
401,2c8edaba-2387-4a58-bd43-2ef1b3e09139,43446359,5469,3945,3898,47,81,81
401,d4c50aa8-bd19-45b8-ba05-83f01547f7ea,43455480,5892,617,23,594,0,61
401,d4c50aa8-bd19-45b8-ba05-83f01547f7ea,43455480,5892,854,619,235,15,61
401,d4c50aa8-bd19-45b8-ba05-83f01547f7ea,43455480,5892,1349,885,464,16,61
401,d4c50aa8-bd19-45b8-ba05-83f01547f7ea,43455480,5892,1366,1351,15,17,61
401,d4c50aa8-bd19-45b8-ba05-83f01547f7ea,43455480,5892,1973,1393,580,22,61
401,d4c50aa8-bd19-45b8-ba05-83f01547f7ea,43455480,5892,2547,1989,558,33,61
401,d4c50aa8-bd19-45b8-ba05-83f01547f7ea,43455480,5892,2730,2568,162,34,61
401,d4c50aa8-bd19-45b8-ba05-83f01547f7ea,43455480,5892,3512,2741,771,45,61
401,d4c50aa8-bd19-45b8-ba05-83f01547f7ea,43455480,5892,3517,3514,3,46,61
401,d4c50aa8-bd19-45b8-ba05-83f01547f7ea,43455480,5892,4279,3564,715,61,61
401,f4b53eea-948c-44c1-a626-a8f60f7534bc,43437097,3840,593,102,491,0,43
401,f4b53eea-948c-44c1-a626-a8f60f7534bc,43437097,3840,752,629,123,1,43
401,f4b53eea-948c-44c1-a626-a8f60f7534bc,43437097,3840,1244,775,469,13,43
401,f4b53eea-948c-44c1-a626-a8f60f7534bc,43437097,3840,1246,1246,0,14,43
401,f4b53eea-948c-44c1-a626-a8f60f7534bc,43437097,3840,1673,1284,389,28,43
401,f4b53eea-948c-44c1-a626-a8f60f7534bc,43437097,3840,1992,1692,300,29,43
401,f4b53eea-948c-44c1-a626-a8f60f7534bc,43437097,3840,2156,2037,119,42,43
401,f4b53eea-948c-44c1-a626-a8f60f7534bc,43437097,3840,2316,2184,132,43,43
401,1fc400f7-e671-41d4-a145-6eb1a7856ca8,43462423,4173,748,208,540,0,33
401,1fc400f7-e671-41d4-a145-6eb1a7856ca8,43462423,4173,1437,754,683,13,33
401,1fc400f7-e671-41d4-a145-6eb1a7856ca8,43462423,4173,1442,1438,4,14,33
401,1fc400f7-e671-41d4-a145-6eb1a7856ca8,43462423,4173,2147,1449,698,24,33
401,1fc400f7-e671-41d4-a145-6eb1a7856ca8,43462423,4173,2649,2175,474,33,33
401,1fc400f7-e671-41d4-a145-6eb1a7856ca8,43435689,7044,569,20,549,0,80
401,1fc400f7-e671-41d4-a145-6eb1a7856ca8,43435689,7044,1096,627,469,6,80
401,1fc400f7-e671-41d4-a145-6eb1a7856ca8,43435689,7044,1240,1113,127,7,80
401,1fc400f7-e671-41d4-a145-6eb1a7856ca8,43435689,7044,2026,1284,742,21,80
401,1fc400f7-e671-41d4-a145-6eb1a7856ca8,43435689,7044,2713,2043,670,31,80
401,1fc400f7-e671-41d4-a145-6eb1a7856ca8,43435689,7044,2712,2712,0,32,80
401,1fc400f7-e671-41d4-a145-6eb1a7856ca8,43435689,7044,3092,2729,363,46,80
401,1fc400f7-e671-41d4-a145-6eb1a7856ca8,43435689,7044,3419,3111,308,47,80
401,1fc400f7-e671-41d4-a145-6eb1a7856ca8,43435689,7044,3764,3431,333,64,80
401,1fc400f7-e671-41d4-a145-6eb1a7856ca8,43435689,7044,4019,3783,236,65,80
401,1fc400f7-e671-41d4-a145-6eb1a7856ca8,43435689,7044,4645,4034,611,69,80
401,1fc400f7-e671-41d4-a145-6eb1a7856ca8,43435689,7044,4685,4655,30,70,80
401,1fc400f7-e671-41d4-a145-6eb1a7856ca8,43435689,7044,5299,4694,605,77,80
401,1fc400f7-e671-41d4-a145-6eb1a7856ca8,43435689,7044,5520,5327,193,80,80
401,ddb6d59b-038d-41da-81fa-00d84487081c,43465700,11589,565,209,356,0,191
401,ddb6d59b-038d-41da-81fa-00d84487081c,43465700,11589,1250,574,676,7,191
401,ddb6d59b-038d-41da-81fa-00d84487081c,43465700,11589,1539,1272,267,8,191
401,ddb6d59b-038d-41da-81fa-00d84487081c,43465700,11589,2277,1556,721,34,191
401,ddb6d59b-038d-41da-81fa-00d84487081c,43465700,11589,2291,2281,10,35,191
401,ddb6d59b-038d-41da-81fa-00d84487081c,43465700,11589,2552,2341,211,52,191
401,ddb6d59b-038d-41da-81fa-00d84487081c,43465700,11589,2918,2578,340,53,191
401,ddb6d59b-038d-41da-81fa-00d84487081c,43465700,11589,3584,2943,641,70,191
401,ddb6d59b-038d-41da-81fa-00d84487081c,43465700,11589,4374,3590,784,91,191
401,ddb6d59b-038d-41da-81fa-00d84487081c,43465700,11589,4684,4410,274,92,191
401,ddb6d59b-038d-41da-81fa-00d84487081c,43465700,11589,5338,4689,649,123,191
401,ddb6d59b-038d-41da-81fa-00d84487081c,43465700,11589,5407,5358,49,124,191
401,ddb6d59b-038d-41da-81fa-00d84487081c,43465700,11589,6192,5438,754,133,191
401,ddb6d59b-038d-41da-81fa-00d84487081c,43465700,11589,6613,6199,414,146,191
401,ddb6d59b-038d-41da-81fa-00d84487081c,43465700,11589,7012,6620,392,147,191
401,ddb6d59b-038d-41da-81fa-00d84487081c,43465700,11589,7011,7011,0,148,191
401,ddb6d59b-038d-41da-81fa-00d84487081c,43465700,11589,7764,7030,734,168,191
401,ddb6d59b-038d-41da-81fa-00d84487081c,43465700,11589,8853,7824,1029,187,191
401,ddb6d59b-038d-41da-81fa-00d84487081c,43465700,11589,8941,8859,82,189,191
401,ddb6d59b-038d-41da-81fa-00d84487081c,43465700,11589,9595,8963,632,190,191
401,ddb6d59b-038d-41da-81fa-00d84487081c,43465700,11589,10065,9604,461,191,191
401,9cb4c17c-557a-4651-bce6-1ee14bcd7355,43494337,15876,150,12,138,0,178
401,9cb4c17c-557a-4651-bce6-1ee14bcd7355,43494337,15876,492,186,306,1,178
401,9cb4c17c-557a-4651-bce6-1ee14bcd7355,43494337,15876,674,502,172,10,178
401,9cb4c17c-557a-4651-bce6-1ee14bcd7355,43494337,15876,765,684,81,11,178
401,9cb4c17c-557a-4651-bce6-1ee14bcd7355,43494337,15876,1042,785,257,16,178
401,9cb4c17c-557a-4651-bce6-1ee14bcd7355,43494337,15876,1866,1065,801,25,178
401,9cb4c17c-557a-4651-bce6-1ee14bcd7355,43494337,15876,2238,1869,369,26,178
401,9cb4c17c-557a-4651-bce6-1ee14bcd7355,43494337,15876,2645,2284,361,37,178
401,9cb4c17c-557a-4651-bce6-1ee14bcd7355,43494337,15876,2660,2650,10,38,178
401,9cb4c17c-557a-4651-bce6-1ee14bcd7355,43494337,15876,3278,2679,599,43,178
401,9cb4c17c-557a-4651-bce6-1ee14bcd7355,43494337,15876,3279,3279,0,44,178
401,9cb4c17c-557a-4651-bce6-1ee14bcd7355,43494337,15876,3446,3303,143,49,178
401,9cb4c17c-557a-4651-bce6-1ee14bcd7355,43494337,15876,3743,3464,279,50,178
401,9cb4c17c-557a-4651-bce6-1ee14bcd7355,43494337,15876,4037,3760,277,55,178
401,9cb4c17c-557a-4651-bce6-1ee14bcd7355,43494337,15876,4114,4048,66,56,178
401,9cb4c17c-557a-4651-bce6-1ee14bcd7355,43494337,15876,4577,4125,452,66,178
401,9cb4c17c-557a-4651-bce6-1ee14bcd7355,43494337,15876,4814,4585,229,68,178
401,9cb4c17c-557a-4651-bce6-1ee14bcd7355,43494337,15876,5141,4830,311,73,178
401,9cb4c17c-557a-4651-bce6-1ee14bcd7355,43494337,15876,5153,5143,10,74,178
401,9cb4c17c-557a-4651-bce6-1ee14bcd7355,43494337,15876,5637,5166,471,82,178
401,9cb4c17c-557a-4651-bce6-1ee14bcd7355,43494337,15876,6277,5652,625,91,178
401,9cb4c17c-557a-4651-bce6-1ee14bcd7355,43494337,15876,6628,6288,340,92,178
401,9cb4c17c-557a-4651-bce6-1ee14bcd7355,43494337,15876,6858,6677,181,93,178
401,9cb4c17c-557a-4651-bce6-1ee14bcd7355,43494337,15876,7231,6843,388,105,178
401,9cb4c17c-557a-4651-bce6-1ee14bcd7355,43494337,15876,7903,7248,655,119,178
401,9cb4c17c-557a-4651-bce6-1ee14bcd7355,43494337,15876,8155,7920,235,127,178
401,9cb4c17c-557a-4651-bce6-1ee14bcd7355,43494337,15876,8521,8166,355,128,178
401,9cb4c17c-557a-4651-bce6-1ee14bcd7355,43494337,15876,9251,8544,707,135,178
401,9cb4c17c-557a-4651-bce6-1ee14bcd7355,43494337,15876,9707,9287,420,150,178
401,9cb4c17c-557a-4651-bce6-1ee14bcd7355,43494337,15876,9871,9713,158,151,178
401,9cb4c17c-557a-4651-bce6-1ee14bcd7355,43494337,15876,10551,9885,666,156,178
401,9cb4c17c-557a-4651-bce6-1ee14bcd7355,43494337,15876,10688,10561,127,157,178
401,9cb4c17c-557a-4651-bce6-1ee14bcd7355,43494337,15876,11024,10713,311,175,178
401,9cb4c17c-557a-4651-bce6-1ee14bcd7355,43494337,15876,11251,11051,200,176,178
401,9cb4c17c-557a-4651-bce6-1ee14bcd7355,43494337,15876,11471,11257,214,177,178
401,9cb4c17c-557a-4651-bce6-1ee14bcd7355,43494337,15876,11630,11473,157,178,178
402,f266e40f-4ee6-4aed-9c87-82a038010700,43633094,6096,243,11,232,0,8
402,f266e40f-4ee6-4aed-9c87-82a038010700,43633094,6096,416,265,151,1,8
402,f266e40f-4ee6-4aed-9c87-82a038010700,43633094,6096,982,404,578,8,8
403,32e91c0b-3b35-470e-8905-cb4307e9420a,43636379,10003,752,33,719,0,127
403,32e91c0b-3b35-470e-8905-cb4307e9420a,43636379,10003,971,767,204,1,127
403,32e91c0b-3b35-470e-8905-cb4307e9420a,43636379,10003,2465,987,1478,2,127
403,32e91c0b-3b35-470e-8905-cb4307e9420a,43636379,10003,2361,0,-2361,3,127
403,32e91c0b-3b35-470e-8905-cb4307e9420a,43636379,10003,54,1,53,5,127
403,32e91c0b-3b35-470e-8905-cb4307e9420a,43636379,10003,51,48,3,6,127
403,32e91c0b-3b35-470e-8905-cb4307e9420a,43636379,10003,601,61,540,7,127
403,32e91c0b-3b35-470e-8905-cb4307e9420a,43636379,10003,721,602,119,8,127
403,32e91c0b-3b35-470e-8905-cb4307e9420a,43636379,10003,737,5,-732,9,127
403,32e91c0b-3b35-470e-8905-cb4307e9420a,43636379,10003,156,0,156,10,127
403,32e91c0b-3b35-470e-8905-cb4307e9420a,43636379,10003,734,163,571,11,127
403,32e91c0b-3b35-470e-8905-cb4307e9420a,43636379,10003,910,744,166,12,127
403,32e91c0b-3b35-470e-8905-cb4307e9420a,43636379,10003,1028,912,116,14,127
403,32e91c0b-3b35-470e-8905-cb4307e9420a,43636379,10003,1031,1029,2,15,127
403,32e91c0b-3b35-470e-8905-cb4307e9420a,43636379,10003,1174,1037,137,18,127
403,32e91c0b-3b35-470e-8905-cb4307e9420a,43636379,10003,1282,1175,107,30,127
403,32e91c0b-3b35-470e-8905-cb4307e9420a,43636379,10003,1451,1290,161,38,127
403,32e91c0b-3b35-470e-8905-cb4307e9420a,43636379,10003,1689,1458,231,55,127
403,32e91c0b-3b35-470e-8905-cb4307e9420a,43636379,10003,1728,1693,35,56,127
403,32e91c0b-3b35-470e-8905-cb4307e9420a,43636379,10003,2079,1744,335,57,127
403,32e91c0b-3b35-470e-8905-cb4307e9420a,43636379,10003,2202,2086,116,58,127
403,32e91c0b-3b35-470e-8905-cb4307e9420a,43636379,10003,2407,2204,203,59,127
403,32e91c0b-3b35-470e-8905-cb4307e9420a,43636379,10003,2538,2408,130,60,127
403,32e91c0b-3b35-470e-8905-cb4307e9420a,43636379,10003,2733,2549,184,82,127
403,32e91c0b-3b35-470e-8905-cb4307e9420a,43636379,10003,3241,2738,503,83,127
403,32e91c0b-3b35-470e-8905-cb4307e9420a,43636379,10003,3389,3250,139,102,127
403,32e91c0b-3b35-470e-8905-cb4307e9420a,43636379,10003,3473,3391,82,112,127
403,32e91c0b-3b35-470e-8905-cb4307e9420a,43636379,10003,3781,3484,297,121,127
403,32e91c0b-3b35-470e-8905-cb4307e9420a,43636379,10003,6105,3810,2295,123,127
403,32e91c0b-3b35-470e-8905-cb4307e9420a,43636379,10003,8103,6123,1980,124,127
403,32e91c0b-3b35-470e-8905-cb4307e9420a,43636379,10003,8316,8113,203,125,127
403,32e91c0b-3b35-470e-8905-cb4307e9420a,43636379,10003,8281,1905,-6376,126,127
403,32e91c0b-3b35-470e-8905-cb4307e9420a,43636379,10003,1852,1391,-461,127,127
403,32e91c0b-3b35-470e-8905-cb4307e9420a,43629255,4501,155,9,146,0,23
403,32e91c0b-3b35-470e-8905-cb4307e9420a,43629255,4501,238,164,74,8,23
403,32e91c0b-3b35-470e-8905-cb4307e9420a,43629255,4501,1522,266,1256,9,23
403,32e91c0b-3b35-470e-8905-cb4307e9420a,43629255,4501,2690,1540,1150,10,23
403,32e91c0b-3b35-470e-8905-cb4307e9420a,43629255,4501,2696,2692,4,11,23
403,32e91c0b-3b35-470e-8905-cb4307e9420a,43629255,4501,2814,2701,113,23,23
404,7aa44cf2-93be-4715-9b50-cf1345664784,43875321,9846,351,26,325,0,4
404,7aa44cf2-93be-4715-9b50-cf1345664784,43875321,9846,1282,435,847,1,4
404,7aa44cf2-93be-4715-9b50-cf1345664784,43875321,9846,2905,1314,1591,2,4
404,7aa44cf2-93be-4715-9b50-cf1345664784,43875321,9846,3101,686,-2415,3,4
404,7aa44cf2-93be-4715-9b50-cf1345664784,43875321,9846,613,413,-200,4,4
405,0fba288c-2301-438f-a883-73b8ee272c0c,43889678,7588,553,28,525,0,2
405,0fba288c-2301-438f-a883-73b8ee272c0c,43889678,7588,1001,490,511,1,2
405,0fba288c-2301-438f-a883-73b8ee272c0c,43889678,7588,1019,1005,14,2,2
406,f0cb45f0-35c9-4a3c-9755-1003967b65ea,44014076,14820,613,17,596,0,74
406,f0cb45f0-35c9-4a3c-9755-1003967b65ea,44014076,14820,1919,697,1222,1,74
406,f0cb45f0-35c9-4a3c-9755-1003967b65ea,44014076,14820,2005,0,-2005,2,74
406,f0cb45f0-35c9-4a3c-9755-1003967b65ea,44014076,14820,28,24,4,3,74
406,f0cb45f0-35c9-4a3c-9755-1003967b65ea,44014076,14820,34,27,7,5,74
406,f0cb45f0-35c9-4a3c-9755-1003967b65ea,44014076,14820,102,35,67,6,74
406,f0cb45f0-35c9-4a3c-9755-1003967b65ea,44014076,14820,176,113,63,10,74
406,f0cb45f0-35c9-4a3c-9755-1003967b65ea,44014076,14820,299,179,120,11,74
406,f0cb45f0-35c9-4a3c-9755-1003967b65ea,44014076,14820,396,301,95,12,74
406,f0cb45f0-35c9-4a3c-9755-1003967b65ea,44014076,14820,447,396,51,13,74
406,f0cb45f0-35c9-4a3c-9755-1003967b65ea,44014076,14820,529,448,81,14,74
406,f0cb45f0-35c9-4a3c-9755-1003967b65ea,44014076,14820,793,530,263,15,74
406,f0cb45f0-35c9-4a3c-9755-1003967b65ea,44014076,14820,1259,795,464,16,74
406,f0cb45f0-35c9-4a3c-9755-1003967b65ea,44014076,14820,2033,1297,736,17,74
406,f0cb45f0-35c9-4a3c-9755-1003967b65ea,44014076,14820,2062,2040,22,18,74
406,f0cb45f0-35c9-4a3c-9755-1003967b65ea,44014076,14820,2477,2068,409,19,74
406,f0cb45f0-35c9-4a3c-9755-1003967b65ea,44014076,14820,2629,2483,146,20,74
406,f0cb45f0-35c9-4a3c-9755-1003967b65ea,44014076,14820,3003,2646,357,21,74
406,f0cb45f0-35c9-4a3c-9755-1003967b65ea,44014076,14820,3726,3025,701,25,74
406,f0cb45f0-35c9-4a3c-9755-1003967b65ea,44014076,14820,4167,3766,401,26,74
406,f0cb45f0-35c9-4a3c-9755-1003967b65ea,44014076,14820,4175,4175,0,40,74
406,f0cb45f0-35c9-4a3c-9755-1003967b65ea,44014076,14820,4224,4187,37,41,74
406,f0cb45f0-35c9-4a3c-9755-1003967b65ea,44014076,14820,4220,4220,0,42,74
406,f0cb45f0-35c9-4a3c-9755-1003967b65ea,44014076,14820,4296,4222,74,43,74
406,f0cb45f0-35c9-4a3c-9755-1003967b65ea,44014076,14820,4365,4297,68,44,74
406,f0cb45f0-35c9-4a3c-9755-1003967b65ea,44014076,14820,4392,4366,26,45,74
406,f0cb45f0-35c9-4a3c-9755-1003967b65ea,44014076,14820,4417,4393,24,46,74
406,f0cb45f0-35c9-4a3c-9755-1003967b65ea,44014076,14820,4429,4417,12,47,74
406,f0cb45f0-35c9-4a3c-9755-1003967b65ea,44014076,14820,4430,4430,0,48,74
406,f0cb45f0-35c9-4a3c-9755-1003967b65ea,44014076,14820,4434,4431,3,49,74
406,f0cb45f0-35c9-4a3c-9755-1003967b65ea,44014076,14820,4435,4435,0,50,74
406,f0cb45f0-35c9-4a3c-9755-1003967b65ea,44014076,14820,4436,4436,0,53,74
406,f0cb45f0-35c9-4a3c-9755-1003967b65ea,44014076,14820,4458,4438,20,55,74
406,f0cb45f0-35c9-4a3c-9755-1003967b65ea,44014076,14820,4514,4459,55,56,74
406,f0cb45f0-35c9-4a3c-9755-1003967b65ea,44014076,14820,4529,4515,14,57,74
406,f0cb45f0-35c9-4a3c-9755-1003967b65ea,44014076,14820,4531,4530,1,58,74
406,f0cb45f0-35c9-4a3c-9755-1003967b65ea,44014076,14820,4533,4530,3,59,74
406,f0cb45f0-35c9-4a3c-9755-1003967b65ea,44014076,14820,4537,4532,5,60,74
406,f0cb45f0-35c9-4a3c-9755-1003967b65ea,44014076,14820,4543,4538,5,61,74
406,f0cb45f0-35c9-4a3c-9755-1003967b65ea,44014076,14820,4664,4545,119,62,74
406,f0cb45f0-35c9-4a3c-9755-1003967b65ea,44014076,14820,5015,4679,336,67,74
406,f0cb45f0-35c9-4a3c-9755-1003967b65ea,44014076,14820,5081,5021,60,68,74
406,f0cb45f0-35c9-4a3c-9755-1003967b65ea,44014076,14820,6574,5098,1476,69,74
406,f0cb45f0-35c9-4a3c-9755-1003967b65ea,44014076,14820,7644,6587,1057,70,74
406,f0cb45f0-35c9-4a3c-9755-1003967b65ea,44014076,14820,8031,7679,352,71,74
406,f0cb45f0-35c9-4a3c-9755-1003967b65ea,44014076,14820,8102,8057,45,72,74
406,f0cb45f0-35c9-4a3c-9755-1003967b65ea,44014076,14820,8875,8090,785,73,74
406,f0cb45f0-35c9-4a3c-9755-1003967b65ea,44014076,14820,10740,8988,1752,74,74
406,f0cb45f0-35c9-4a3c-9755-1003967b65ea,44012046,11733,533,1,532,0,395
406,f0cb45f0-35c9-4a3c-9755-1003967b65ea,44012046,11733,534,534,0,1,395
406,f0cb45f0-35c9-4a3c-9755-1003967b65ea,44012046,11733,725,535,190,16,395
406,f0cb45f0-35c9-4a3c-9755-1003967b65ea,44012046,11733,1106,734,372,17,395
406,f0cb45f0-35c9-4a3c-9755-1003967b65ea,44012046,11733,1365,1114,251,25,395
406,f0cb45f0-35c9-4a3c-9755-1003967b65ea,44012046,11733,1426,1371,55,26,395
406,f0cb45f0-35c9-4a3c-9755-1003967b65ea,44012046,11733,1523,1433,90,51,395
406,f0cb45f0-35c9-4a3c-9755-1003967b65ea,44012046,11733,1707,1528,179,61,395
406,f0cb45f0-35c9-4a3c-9755-1003967b65ea,44012046,11733,1844,1712,132,62,395
406,f0cb45f0-35c9-4a3c-9755-1003967b65ea,44012046,11733,2123,1848,275,87,395
406,f0cb45f0-35c9-4a3c-9755-1003967b65ea,44012046,11733,2199,2128,71,88,395
406,f0cb45f0-35c9-4a3c-9755-1003967b65ea,44012046,11733,2282,2202,80,89,395
406,f0cb45f0-35c9-4a3c-9755-1003967b65ea,44012046,11733,2550,2298,252,106,395
406,f0cb45f0-35c9-4a3c-9755-1003967b65ea,44012046,11733,2856,2554,302,107,395
406,f0cb45f0-35c9-4a3c-9755-1003967b65ea,44012046,11733,2976,2857,119,123,395
406,f0cb45f0-35c9-4a3c-9755-1003967b65ea,44012046,11733,3113,2981,132,124,395
406,f0cb45f0-35c9-4a3c-9755-1003967b65ea,44012046,11733,3289,3124,165,144,395
406,f0cb45f0-35c9-4a3c-9755-1003967b65ea,44012046,11733,3547,3308,239,154,395
406,f0cb45f0-35c9-4a3c-9755-1003967b65ea,44012046,11733,3631,3554,77,155,395
406,f0cb45f0-35c9-4a3c-9755-1003967b65ea,44012046,11733,3630,3630,0,156,395
406,f0cb45f0-35c9-4a3c-9755-1003967b65ea,44012046,11733,3797,3641,156,164,395
406,f0cb45f0-35c9-4a3c-9755-1003967b65ea,44012046,11733,3798,3798,0,165,395
406,f0cb45f0-35c9-4a3c-9755-1003967b65ea,44012046,11733,3992,3843,149,171,395
406,f0cb45f0-35c9-4a3c-9755-1003967b65ea,44012046,11733,4272,3990,282,172,395
406,f0cb45f0-35c9-4a3c-9755-1003967b65ea,44012046,11733,4151,4147,4,173,395
406,f0cb45f0-35c9-4a3c-9755-1003967b65ea,44012046,11733,4150,3918,-232,174,395
406,f0cb45f0-35c9-4a3c-9755-1003967b65ea,44012046,11733,3914,3875,-39,175,395
406,f0cb45f0-35c9-4a3c-9755-1003967b65ea,44012046,11733,3974,3892,82,193,395
406,f0cb45f0-35c9-4a3c-9755-1003967b65ea,44012046,11733,4302,3987,315,194,395
406,f0cb45f0-35c9-4a3c-9755-1003967b65ea,44012046,11733,4317,4303,14,195,395
406,f0cb45f0-35c9-4a3c-9755-1003967b65ea,44012046,11733,4454,4342,112,205,395
406,f0cb45f0-35c9-4a3c-9755-1003967b65ea,44012046,11733,4460,4455,5,206,395
406,f0cb45f0-35c9-4a3c-9755-1003967b65ea,44012046,11733,4466,4461,5,207,395
406,f0cb45f0-35c9-4a3c-9755-1003967b65ea,44012046,11733,4501,4467,34,208,395
406,f0cb45f0-35c9-4a3c-9755-1003967b65ea,44012046,11733,4507,4499,8,209,395
406,f0cb45f0-35c9-4a3c-9755-1003967b65ea,44012046,11733,4508,4315,-193,210,395
406,f0cb45f0-35c9-4a3c-9755-1003967b65ea,44012046,11733,4312,3857,-455,211,395
406,f0cb45f0-35c9-4a3c-9755-1003967b65ea,44012046,11733,3889,3831,58,212,395
406,f0cb45f0-35c9-4a3c-9755-1003967b65ea,44012046,11733,3888,3757,-131,213,395
406,f0cb45f0-35c9-4a3c-9755-1003967b65ea,44012046,11733,3756,3724,-32,214,395
406,f0cb45f0-35c9-4a3c-9755-1003967b65ea,44012046,11733,3722,3469,-253,215,395
406,f0cb45f0-35c9-4a3c-9755-1003967b65ea,44012046,11733,3466,3199,-267,216,395
406,f0cb45f0-35c9-4a3c-9755-1003967b65ea,44012046,11733,3198,3172,-26,217,395
406,f0cb45f0-35c9-4a3c-9755-1003967b65ea,44012046,11733,3171,3162,-9,218,395
406,f0cb45f0-35c9-4a3c-9755-1003967b65ea,44012046,11733,3161,3094,-67,219,395
406,f0cb45f0-35c9-4a3c-9755-1003967b65ea,44012046,11733,3087,3025,-62,220,395
406,f0cb45f0-35c9-4a3c-9755-1003967b65ea,44012046,11733,3024,3021,-3,221,395
406,f0cb45f0-35c9-4a3c-9755-1003967b65ea,44012046,11733,3020,3019,-1,222,395
406,f0cb45f0-35c9-4a3c-9755-1003967b65ea,44012046,11733,3018,3018,0,223,395
406,f0cb45f0-35c9-4a3c-9755-1003967b65ea,44012046,11733,3025,3019,6,224,395
406,f0cb45f0-35c9-4a3c-9755-1003967b65ea,44012046,11733,3046,3027,19,225,395
406,f0cb45f0-35c9-4a3c-9755-1003967b65ea,44012046,11733,3141,3047,94,226,395
406,f0cb45f0-35c9-4a3c-9755-1003967b65ea,44012046,11733,3218,3145,73,227,395
406,f0cb45f0-35c9-4a3c-9755-1003967b65ea,44012046,11733,3261,3219,42,228,395
406,f0cb45f0-35c9-4a3c-9755-1003967b65ea,44012046,11733,3275,3262,13,234,395
406,f0cb45f0-35c9-4a3c-9755-1003967b65ea,44012046,11733,3356,3276,80,235,395
406,f0cb45f0-35c9-4a3c-9755-1003967b65ea,44012046,11733,3399,3357,42,236,395
406,f0cb45f0-35c9-4a3c-9755-1003967b65ea,44012046,11733,3409,3400,9,237,395
406,f0cb45f0-35c9-4a3c-9755-1003967b65ea,44012046,11733,3422,3410,12,238,395
406,f0cb45f0-35c9-4a3c-9755-1003967b65ea,44012046,11733,3441,3423,18,239,395
406,f0cb45f0-35c9-4a3c-9755-1003967b65ea,44012046,11733,3595,3442,153,240,395
406,f0cb45f0-35c9-4a3c-9755-1003967b65ea,44012046,11733,3618,3596,22,241,395
406,f0cb45f0-35c9-4a3c-9755-1003967b65ea,44012046,11733,3622,3622,0,242,395
406,f0cb45f0-35c9-4a3c-9755-1003967b65ea,44012046,11733,3688,3628,60,243,395
406,f0cb45f0-35c9-4a3c-9755-1003967b65ea,44012046,11733,3697,3690,7,244,395
406,f0cb45f0-35c9-4a3c-9755-1003967b65ea,44012046,11733,3718,3698,20,245,395
406,f0cb45f0-35c9-4a3c-9755-1003967b65ea,44012046,11733,3748,3720,28,246,395
406,f0cb45f0-35c9-4a3c-9755-1003967b65ea,44012046,11733,3763,3749,14,247,395
406,f0cb45f0-35c9-4a3c-9755-1003967b65ea,44012046,11733,3802,3764,38,248,395
406,f0cb45f0-35c9-4a3c-9755-1003967b65ea,44012046,11733,3816,3804,12,249,395
406,f0cb45f0-35c9-4a3c-9755-1003967b65ea,44012046,11733,3838,3817,21,250,395
406,f0cb45f0-35c9-4a3c-9755-1003967b65ea,44012046,11733,3875,3840,35,251,395
406,f0cb45f0-35c9-4a3c-9755-1003967b65ea,44012046,11733,3955,3876,79,252,395
406,f0cb45f0-35c9-4a3c-9755-1003967b65ea,44012046,11733,4000,3959,41,253,395
406,f0cb45f0-35c9-4a3c-9755-1003967b65ea,44012046,11733,4116,4003,113,258,395
406,f0cb45f0-35c9-4a3c-9755-1003967b65ea,44012046,11733,4146,4118,28,259,395
406,f0cb45f0-35c9-4a3c-9755-1003967b65ea,44012046,11733,4145,4145,0,260,395
406,f0cb45f0-35c9-4a3c-9755-1003967b65ea,44012046,11733,4205,4146,59,261,395
406,f0cb45f0-35c9-4a3c-9755-1003967b65ea,44012046,11733,4229,4207,22,262,395
406,f0cb45f0-35c9-4a3c-9755-1003967b65ea,44012046,11733,4307,4232,75,268,395
406,f0cb45f0-35c9-4a3c-9755-1003967b65ea,44012046,11733,4324,4308,16,269,395
406,f0cb45f0-35c9-4a3c-9755-1003967b65ea,44012046,11733,4341,4325,16,270,395
406,f0cb45f0-35c9-4a3c-9755-1003967b65ea,44012046,11733,4406,4343,63,271,395
406,f0cb45f0-35c9-4a3c-9755-1003967b65ea,44012046,11733,4442,4407,35,272,395
406,f0cb45f0-35c9-4a3c-9755-1003967b65ea,44012046,11733,4495,4443,52,273,395
406,f0cb45f0-35c9-4a3c-9755-1003967b65ea,44012046,11733,4597,4494,103,274,395
406,f0cb45f0-35c9-4a3c-9755-1003967b65ea,44012046,11733,4639,4599,40,275,395
406,f0cb45f0-35c9-4a3c-9755-1003967b65ea,44012046,11733,4658,4641,17,276,395
406,f0cb45f0-35c9-4a3c-9755-1003967b65ea,44012046,11733,4676,4659,17,277,395
406,f0cb45f0-35c9-4a3c-9755-1003967b65ea,44012046,11733,4683,4677,6,278,395
406,f0cb45f0-35c9-4a3c-9755-1003967b65ea,44012046,11733,4833,4684,149,279,395
406,f0cb45f0-35c9-4a3c-9755-1003967b65ea,44012046,11733,4883,4835,48,280,395
406,f0cb45f0-35c9-4a3c-9755-1003967b65ea,44012046,11733,5154,4887,267,281,395
406,f0cb45f0-35c9-4a3c-9755-1003967b65ea,44012046,11733,5182,5155,27,282,395
406,f0cb45f0-35c9-4a3c-9755-1003967b65ea,44012046,11733,5181,5172,-9,283,395
406,f0cb45f0-35c9-4a3c-9755-1003967b65ea,44012046,11733,5171,5037,-134,284,395
406,f0cb45f0-35c9-4a3c-9755-1003967b65ea,44012046,11733,5031,4757,-274,285,395
406,f0cb45f0-35c9-4a3c-9755-1003967b65ea,44012046,11733,4926,4759,167,286,395
406,f0cb45f0-35c9-4a3c-9755-1003967b65ea,44012046,11733,4989,4690,-299,287,395
406,f0cb45f0-35c9-4a3c-9755-1003967b65ea,44012046,11733,4689,4660,-29,288,395
406,f0cb45f0-35c9-4a3c-9755-1003967b65ea,44012046,11733,4760,4684,76,289,395
406,f0cb45f0-35c9-4a3c-9755-1003967b65ea,44012046,11733,4831,4763,68,290,395
406,f0cb45f0-35c9-4a3c-9755-1003967b65ea,44012046,11733,4847,4838,9,291,395
406,f0cb45f0-35c9-4a3c-9755-1003967b65ea,44012046,11733,4885,4853,32,292,395
406,f0cb45f0-35c9-4a3c-9755-1003967b65ea,44012046,11733,4904,4886,18,293,395
406,f0cb45f0-35c9-4a3c-9755-1003967b65ea,44012046,11733,4924,4905,19,294,395
406,f0cb45f0-35c9-4a3c-9755-1003967b65ea,44012046,11733,4941,4925,16,295,395
406,f0cb45f0-35c9-4a3c-9755-1003967b65ea,44012046,11733,5406,4942,464,296,395
406,f0cb45f0-35c9-4a3c-9755-1003967b65ea,44012046,11733,7064,5411,1653,297,395
406,f0cb45f0-35c9-4a3c-9755-1003967b65ea,44012046,11733,7328,7068,260,298,395
406,f0cb45f0-35c9-4a3c-9755-1003967b65ea,44012046,11733,7523,7330,193,299,395
406,f0cb45f0-35c9-4a3c-9755-1003967b65ea,44012046,11733,7783,7527,256,300,395
406,f0cb45f0-35c9-4a3c-9755-1003967b65ea,44012046,11733,7703,7402,-301,304,395
406,f0cb45f0-35c9-4a3c-9755-1003967b65ea,44012046,11733,7399,6842,-557,305,395
406,f0cb45f0-35c9-4a3c-9755-1003967b65ea,44012046,11733,6800,5906,-894,306,395
406,f0cb45f0-35c9-4a3c-9755-1003967b65ea,44012046,11733,5939,5905,34,307,395
406,f0cb45f0-35c9-4a3c-9755-1003967b65ea,44012046,11733,6004,5943,61,308,395
406,f0cb45f0-35c9-4a3c-9755-1003967b65ea,44012046,11733,6072,5997,75,309,395
406,f0cb45f0-35c9-4a3c-9755-1003967b65ea,44012046,11733,6115,6073,42,310,395
406,f0cb45f0-35c9-4a3c-9755-1003967b65ea,44012046,11733,6126,6115,11,311,395
406,f0cb45f0-35c9-4a3c-9755-1003967b65ea,44012046,11733,6139,6128,11,312,395
406,f0cb45f0-35c9-4a3c-9755-1003967b65ea,44012046,11733,6201,6140,61,313,395
406,f0cb45f0-35c9-4a3c-9755-1003967b65ea,44012046,11733,6260,6204,56,314,395
406,f0cb45f0-35c9-4a3c-9755-1003967b65ea,44012046,11733,6357,6261,96,315,395
406,f0cb45f0-35c9-4a3c-9755-1003967b65ea,44012046,11733,6373,6358,15,316,395
406,f0cb45f0-35c9-4a3c-9755-1003967b65ea,44012046,11733,6398,6374,24,317,395
406,f0cb45f0-35c9-4a3c-9755-1003967b65ea,44012046,11733,6464,6399,65,318,395
406,f0cb45f0-35c9-4a3c-9755-1003967b65ea,44012046,11733,6480,6465,15,319,395
406,f0cb45f0-35c9-4a3c-9755-1003967b65ea,44012046,11733,6562,6482,80,320,395
406,f0cb45f0-35c9-4a3c-9755-1003967b65ea,44012046,11733,6568,6568,0,321,395
406,f0cb45f0-35c9-4a3c-9755-1003967b65ea,44012046,11733,6647,6572,75,322,395
406,f0cb45f0-35c9-4a3c-9755-1003967b65ea,44012046,11733,6729,6649,80,323,395
406,f0cb45f0-35c9-4a3c-9755-1003967b65ea,44012046,11733,6746,6730,16,324,395
406,f0cb45f0-35c9-4a3c-9755-1003967b65ea,44012046,11733,6759,6747,12,325,395
406,f0cb45f0-35c9-4a3c-9755-1003967b65ea,44012046,11733,6810,6760,50,326,395
406,f0cb45f0-35c9-4a3c-9755-1003967b65ea,44012046,11733,6834,6811,23,327,395
406,f0cb45f0-35c9-4a3c-9755-1003967b65ea,44012046,11733,6859,6835,24,328,395
406,f0cb45f0-35c9-4a3c-9755-1003967b65ea,44012046,11733,6893,6860,33,329,395
406,f0cb45f0-35c9-4a3c-9755-1003967b65ea,44012046,11733,6919,6895,24,330,395
406,f0cb45f0-35c9-4a3c-9755-1003967b65ea,44012046,11733,6953,6920,33,331,395
406,f0cb45f0-35c9-4a3c-9755-1003967b65ea,44012046,11733,6991,6954,37,332,395
406,f0cb45f0-35c9-4a3c-9755-1003967b65ea,44012046,11733,7016,6988,28,333,395
406,f0cb45f0-35c9-4a3c-9755-1003967b65ea,44012046,11733,7044,7017,27,334,395
406,f0cb45f0-35c9-4a3c-9755-1003967b65ea,44012046,11733,7099,7045,54,335,395
406,f0cb45f0-35c9-4a3c-9755-1003967b65ea,44012046,11733,7154,7100,54,336,395
406,f0cb45f0-35c9-4a3c-9755-1003967b65ea,44012046,11733,7224,7160,64,338,395
406,f0cb45f0-35c9-4a3c-9755-1003967b65ea,44012046,11733,7232,7225,7,339,395
406,f0cb45f0-35c9-4a3c-9755-1003967b65ea,44012046,11733,7253,7234,19,340,395
406,f0cb45f0-35c9-4a3c-9755-1003967b65ea,44012046,11733,7269,7254,15,341,395
406,f0cb45f0-35c9-4a3c-9755-1003967b65ea,44012046,11733,7285,7270,15,342,395
406,f0cb45f0-35c9-4a3c-9755-1003967b65ea,44012046,11733,7307,7287,20,343,395
406,f0cb45f0-35c9-4a3c-9755-1003967b65ea,44012046,11733,7333,7308,25,344,395
406,f0cb45f0-35c9-4a3c-9755-1003967b65ea,44012046,11733,7362,7334,28,345,395
406,f0cb45f0-35c9-4a3c-9755-1003967b65ea,44012046,11733,7377,7363,14,346,395
406,f0cb45f0-35c9-4a3c-9755-1003967b65ea,44012046,11733,7386,7378,8,347,395
406,f0cb45f0-35c9-4a3c-9755-1003967b65ea,44012046,11733,7408,7387,21,348,395
406,f0cb45f0-35c9-4a3c-9755-1003967b65ea,44012046,11733,7462,7409,53,349,395
406,f0cb45f0-35c9-4a3c-9755-1003967b65ea,44012046,11733,7503,7463,40,350,395
406,f0cb45f0-35c9-4a3c-9755-1003967b65ea,44012046,11733,7522,7504,18,351,395
406,f0cb45f0-35c9-4a3c-9755-1003967b65ea,44012046,11733,7526,7523,3,352,395
406,f0cb45f0-35c9-4a3c-9755-1003967b65ea,44012046,11733,7525,7525,0,354,395
406,f0cb45f0-35c9-4a3c-9755-1003967b65ea,44012046,11733,7539,7527,12,355,395
406,f0cb45f0-35c9-4a3c-9755-1003967b65ea,44012046,11733,7559,7541,18,356,395
406,f0cb45f0-35c9-4a3c-9755-1003967b65ea,44012046,11733,7563,7560,3,357,395
406,f0cb45f0-35c9-4a3c-9755-1003967b65ea,44012046,11733,7573,7564,9,358,395
406,f0cb45f0-35c9-4a3c-9755-1003967b65ea,44012046,11733,7658,7574,84,359,395
406,f0cb45f0-35c9-4a3c-9755-1003967b65ea,44012046,11733,7708,7659,49,360,395
406,f0cb45f0-35c9-4a3c-9755-1003967b65ea,44012046,11733,7718,7709,9,361,395
406,f0cb45f0-35c9-4a3c-9755-1003967b65ea,44012046,11733,7747,7719,28,362,395
406,f0cb45f0-35c9-4a3c-9755-1003967b65ea,44012046,11733,7770,7748,22,363,395
406,f0cb45f0-35c9-4a3c-9755-1003967b65ea,44012046,11733,8097,7790,307,370,395
406,f0cb45f0-35c9-4a3c-9755-1003967b65ea,44012046,11733,8628,8098,530,371,395
406,f0cb45f0-35c9-4a3c-9755-1003967b65ea,44012046,11733,9757,8629,1128,372,395
406,f0cb45f0-35c9-4a3c-9755-1003967b65ea,44012046,11733,9929,9764,165,373,395
406,f0cb45f0-35c9-4a3c-9755-1003967b65ea,44012046,11733,10053,9928,125,374,395
406,f0cb45f0-35c9-4a3c-9755-1003967b65ea,44012046,11733,10023,9830,-193,380,395
406,f0cb45f0-35c9-4a3c-9755-1003967b65ea,44012046,11733,10053,9917,136,381,395
406,f0cb45f0-35c9-4a3c-9755-1003967b65ea,44012046,1680,0,0,0,384,395
406,f0cb45f0-35c9-4a3c-9755-1003967b65ea,44012046,23298,237,9,228,390,395
406,f0cb45f0-35c9-4a3c-9755-1003967b65ea,44012046,23952,963,240,723,391,395
406,f0cb45f0-35c9-4a3c-9755-1003967b65ea,44012046,24144,2799,964,1835,393,395
406,f0cb45f0-35c9-4a3c-9755-1003967b65ea,44012046,24144,5066,2818,2248,394,395
406,f0cb45f0-35c9-4a3c-9755-1003967b65ea,44012046,24144,5127,5077,50,395,395
407,b882783c-1dc3-4b16-96d9-516bb4b305ae,44011112,3855,95,28,67,0,10
407,b882783c-1dc3-4b16-96d9-516bb4b305ae,44011112,3855,329,96,233,1,10
407,b882783c-1dc3-4b16-96d9-516bb4b305ae,44011112,3855,441,337,104,2,10
407,b882783c-1dc3-4b16-96d9-516bb4b305ae,44011112,3855,528,445,83,3,10
407,b882783c-1dc3-4b16-96d9-516bb4b305ae,44011112,3855,659,538,121,4,10
407,b882783c-1dc3-4b16-96d9-516bb4b305ae,44011112,3855,1617,674,943,5,10
407,b882783c-1dc3-4b16-96d9-516bb4b305ae,44011112,3855,1766,1645,121,6,10
407,b882783c-1dc3-4b16-96d9-516bb4b305ae,44011112,3855,2384,1771,613,7,10
407,b882783c-1dc3-4b16-96d9-516bb4b305ae,44011112,3855,2442,2392,50,8,10
407,b882783c-1dc3-4b16-96d9-516bb4b305ae,44011112,3855,2475,2446,29,9,10
407,b882783c-1dc3-4b16-96d9-516bb4b305ae,44011112,3855,2449,0,-2449,10,10
406,73464d69-81ef-493e-9819-d8e5efa9710d,43981895,8838,138,42,96,0,177
406,73464d69-81ef-493e-9819-d8e5efa9710d,43981895,8838,190,0,-190,1,177
406,73464d69-81ef-493e-9819-d8e5efa9710d,43981895,8838,186,1,185,2,177
406,73464d69-81ef-493e-9819-d8e5efa9710d,43981895,8838,336,190,146,3,177
406,73464d69-81ef-493e-9819-d8e5efa9710d,43981895,8838,493,334,159,4,177
406,73464d69-81ef-493e-9819-d8e5efa9710d,43981895,8838,771,498,273,5,177
406,73464d69-81ef-493e-9819-d8e5efa9710d,43981895,8838,932,780,152,6,177
406,73464d69-81ef-493e-9819-d8e5efa9710d,43981895,8838,1218,961,257,8,177
406,73464d69-81ef-493e-9819-d8e5efa9710d,43981895,8838,1228,1221,7,9,177
406,73464d69-81ef-493e-9819-d8e5efa9710d,43981895,8838,1275,1222,53,10,177
406,73464d69-81ef-493e-9819-d8e5efa9710d,43981895,8838,1322,1224,-98,11,177
406,73464d69-81ef-493e-9819-d8e5efa9710d,43981895,8838,1223,1206,-17,12,177
406,73464d69-81ef-493e-9819-d8e5efa9710d,43981895,8838,1218,1205,13,13,177
406,73464d69-81ef-493e-9819-d8e5efa9710d,43981895,8838,1439,1233,206,34,177
406,73464d69-81ef-493e-9819-d8e5efa9710d,43981895,8838,1767,1458,309,35,177
406,73464d69-81ef-493e-9819-d8e5efa9710d,43981895,8838,1836,1778,58,51,177
406,73464d69-81ef-493e-9819-d8e5efa9710d,43981895,8838,2027,1844,183,52,177
406,73464d69-81ef-493e-9819-d8e5efa9710d,43981895,8838,2181,2032,149,53,177
406,73464d69-81ef-493e-9819-d8e5efa9710d,43981895,8838,2296,2180,116,59,177
406,73464d69-81ef-493e-9819-d8e5efa9710d,43981895,8838,2751,2302,449,60,177
406,73464d69-81ef-493e-9819-d8e5efa9710d,43981895,8838,3009,2784,225,61,177
406,73464d69-81ef-493e-9819-d8e5efa9710d,43981895,8838,3326,3040,286,84,177
406,73464d69-81ef-493e-9819-d8e5efa9710d,43981895,8838,4053,3336,717,85,177
406,73464d69-81ef-493e-9819-d8e5efa9710d,43981895,8838,4377,4077,300,99,177
406,73464d69-81ef-493e-9819-d8e5efa9710d,43981895,8838,4381,4375,-6,100,177
406,73464d69-81ef-493e-9819-d8e5efa9710d,43981895,8838,4573,4426,147,116,177
406,73464d69-81ef-493e-9819-d8e5efa9710d,43981895,8838,4900,4576,324,117,177
406,73464d69-81ef-493e-9819-d8e5efa9710d,43981895,8838,5026,4902,124,119,177
406,73464d69-81ef-493e-9819-d8e5efa9710d,43981895,8838,5321,5031,290,120,177
406,73464d69-81ef-493e-9819-d8e5efa9710d,43981895,8838,5351,5323,28,121,177
406,73464d69-81ef-493e-9819-d8e5efa9710d,43981895,8838,5449,5360,89,123,177
406,73464d69-81ef-493e-9819-d8e5efa9710d,43981895,8838,5548,5453,95,124,177
406,73464d69-81ef-493e-9819-d8e5efa9710d,43981895,8838,6516,5550,966,125,177
406,73464d69-81ef-493e-9819-d8e5efa9710d,43981895,8838,6801,6360,-441,126,177
406,73464d69-81ef-493e-9819-d8e5efa9710d,43981895,8838,6307,5284,-1023,127,177
406,73464d69-81ef-493e-9819-d8e5efa9710d,43981895,8838,5464,5295,169,153,177
406,73464d69-81ef-493e-9819-d8e5efa9710d,43981895,8838,5579,5431,148,162,177
406,73464d69-81ef-493e-9819-d8e5efa9710d,43981895,8838,6011,5601,410,163,177
406,73464d69-81ef-493e-9819-d8e5efa9710d,43981895,8838,6747,6019,728,172,177
406,73464d69-81ef-493e-9819-d8e5efa9710d,43981895,8838,7158,6646,-512,173,177
406,73464d69-81ef-493e-9819-d8e5efa9710d,43981895,8838,7080,6671,409,177,177
406,f3ccff50-fc58-4430-804b-b928b8dba3f9,44010298,5568,70,10,60,0,107
406,f3ccff50-fc58-4430-804b-b928b8dba3f9,44010298,5568,65,64,-1,1,107
406,f3ccff50-fc58-4430-804b-b928b8dba3f9,44010298,5568,63,60,-3,2,107
406,f3ccff50-fc58-4430-804b-b928b8dba3f9,44010298,5568,130,51,79,3,107
406,f3ccff50-fc58-4430-804b-b928b8dba3f9,44010298,5568,581,133,448,4,107
406,f3ccff50-fc58-4430-804b-b928b8dba3f9,44010298,5568,1107,618,489,5,107
406,f3ccff50-fc58-4430-804b-b928b8dba3f9,44010298,5568,1411,1113,298,17,107
406,f3ccff50-fc58-4430-804b-b928b8dba3f9,44010298,5568,1466,1415,51,18,107
406,f3ccff50-fc58-4430-804b-b928b8dba3f9,44010298,5568,1669,1469,200,30,107
406,f3ccff50-fc58-4430-804b-b928b8dba3f9,44010298,5568,1854,1697,157,31,107
406,f3ccff50-fc58-4430-804b-b928b8dba3f9,44010298,5568,1866,1840,26,55,107
406,f3ccff50-fc58-4430-804b-b928b8dba3f9,44010298,5568,1877,1868,9,56,107
406,f3ccff50-fc58-4430-804b-b928b8dba3f9,44010298,5568,2730,1905,825,77,107
406,f3ccff50-fc58-4430-804b-b928b8dba3f9,44010298,5568,3888,2745,1143,78,107
406,f3ccff50-fc58-4430-804b-b928b8dba3f9,44010298,5568,3886,3063,-823,79,107
406,f3ccff50-fc58-4430-804b-b928b8dba3f9,44010298,5568,3118,3071,47,106,107
406,f3ccff50-fc58-4430-804b-b928b8dba3f9,44010298,5568,3344,3129,215,107,107
407,d62e979f-9b86-4f5f-9853-7dca35ad500c,43995168,6972,202,1,201,0,19
407,d62e979f-9b86-4f5f-9853-7dca35ad500c,43995168,6972,347,213,134,1,19
407,d62e979f-9b86-4f5f-9853-7dca35ad500c,43995168,6972,465,353,112,2,19
407,d62e979f-9b86-4f5f-9853-7dca35ad500c,43995168,6972,1177,467,710,3,19
407,d62e979f-9b86-4f5f-9853-7dca35ad500c,43995168,6972,1250,1182,68,4,19
407,d62e979f-9b86-4f5f-9853-7dca35ad500c,43995168,6972,1346,1256,90,5,19
407,d62e979f-9b86-4f5f-9853-7dca35ad500c,43995168,6972,1578,1355,223,6,19
407,d62e979f-9b86-4f5f-9853-7dca35ad500c,43995168,6972,1981,1580,401,7,19
407,d62e979f-9b86-4f5f-9853-7dca35ad500c,43995168,6972,2418,1990,428,8,19
407,d62e979f-9b86-4f5f-9853-7dca35ad500c,43995168,6972,2515,2419,96,9,19
407,d62e979f-9b86-4f5f-9853-7dca35ad500c,43995168,6972,2669,2521,148,10,19
407,d62e979f-9b86-4f5f-9853-7dca35ad500c,43995168,6972,2760,2671,89,12,19
407,d62e979f-9b86-4f5f-9853-7dca35ad500c,43995168,6972,2839,2765,74,13,19
407,d62e979f-9b86-4f5f-9853-7dca35ad500c,43995168,6972,3028,2848,180,15,19
407,d62e979f-9b86-4f5f-9853-7dca35ad500c,43995168,6972,3181,3032,149,16,19
407,d62e979f-9b86-4f5f-9853-7dca35ad500c,43995168,6972,3618,3187,431,17,19
407,d62e979f-9b86-4f5f-9853-7dca35ad500c,43995168,6972,4595,3627,968,18,19
407,d62e979f-9b86-4f5f-9853-7dca35ad500c,43995168,6972,5592,4660,932,19,19
407,991f2c93-8a98-4a88-b9eb-084e9e2f016f,44017054,8046,304,22,282,0,14
407,991f2c93-8a98-4a88-b9eb-084e9e2f016f,44017054,8046,415,312,103,5,14
407,991f2c93-8a98-4a88-b9eb-084e9e2f016f,44017054,8046,654,417,237,6,14
407,991f2c93-8a98-4a88-b9eb-084e9e2f016f,44017054,8046,733,661,72,7,14
407,991f2c93-8a98-4a88-b9eb-084e9e2f016f,44017054,8046,794,737,57,8,14
407,991f2c93-8a98-4a88-b9eb-084e9e2f016f,44017054,8046,1511,806,705,9,14
407,991f2c93-8a98-4a88-b9eb-084e9e2f016f,44017054,8046,1934,1535,399,10,14
407,991f2c93-8a98-4a88-b9eb-084e9e2f016f,44017054,8046,2120,1944,176,11,14
407,991f2c93-8a98-4a88-b9eb-084e9e2f016f,44017054,8046,2525,2124,401,12,14
407,991f2c93-8a98-4a88-b9eb-084e9e2f016f,44017054,8046,3029,2562,467,13,14
407,991f2c93-8a98-4a88-b9eb-084e9e2f016f,44017054,8046,3202,3037,165,14,14
406,d8facddc-edb4-4612-97ff-5a069db847c1,44011112,6165,1423,51,1372,0,27
406,d8facddc-edb4-4612-97ff-5a069db847c1,44011112,6165,1684,1448,236,1,27
406,d8facddc-edb4-4612-97ff-5a069db847c1,44011112,6165,4406,1686,2720,7,27
406,d8facddc-edb4-4612-97ff-5a069db847c1,44011112,6165,4485,4426,59,8,27
406,d8facddc-edb4-4612-97ff-5a069db847c1,44011112,6165,4483,3270,-1213,18,27
406,d8facddc-edb4-4612-97ff-5a069db847c1,44011112,6165,3264,3240,-24,19,27
406,d8facddc-edb4-4612-97ff-5a069db847c1,44011112,6165,3324,2848,-476,24,27
406,d8facddc-edb4-4612-97ff-5a069db847c1,44011112,6165,2823,1111,-1712,25,27
406,d8facddc-edb4-4612-97ff-5a069db847c1,44011112,6165,1096,209,-887,26,27
406,d8facddc-edb4-4612-97ff-5a069db847c1,44011112,6165,788,567,221,27,27
406,d8facddc-edb4-4612-97ff-5a069db847c1,44015562,4683,114,6,108,0,30
406,d8facddc-edb4-4612-97ff-5a069db847c1,44015562,4683,311,125,186,3,30
406,d8facddc-edb4-4612-97ff-5a069db847c1,44015562,4683,540,332,208,4,30
406,d8facddc-edb4-4612-97ff-5a069db847c1,44015562,4683,711,553,158,5,30
406,d8facddc-edb4-4612-97ff-5a069db847c1,44015562,4683,818,721,97,6,30
406,d8facddc-edb4-4612-97ff-5a069db847c1,44015562,4683,905,788,117,7,30
406,d8facddc-edb4-4612-97ff-5a069db847c1,44015562,4683,1058,919,139,16,30
406,d8facddc-edb4-4612-97ff-5a069db847c1,44015562,4683,1242,1066,176,17,30
406,d8facddc-edb4-4612-97ff-5a069db847c1,44015562,4683,1801,1252,549,18,30
406,d8facddc-edb4-4612-97ff-5a069db847c1,44015562,4683,2012,1809,203,19,30
406,d8facddc-edb4-4612-97ff-5a069db847c1,44015562,4683,2200,2014,186,20,30
406,d8facddc-edb4-4612-97ff-5a069db847c1,44015562,4683,2406,2201,205,21,30
406,d8facddc-edb4-4612-97ff-5a069db847c1,44015562,4683,2627,2412,215,22,30
406,d8facddc-edb4-4612-97ff-5a069db847c1,44015562,4683,3003,2650,353,23,30
406,d8facddc-edb4-4612-97ff-5a069db847c1,44015562,4683,3001,2979,-22,25,30
406,d8facddc-edb4-4612-97ff-5a069db847c1,44015562,4683,3003,2994,9,26,30
406,d8facddc-edb4-4612-97ff-5a069db847c1,44015562,4683,3000,2977,-23,27,30
406,d8facddc-edb4-4612-97ff-5a069db847c1,44015562,4683,3003,2986,17,29,30
406,d8facddc-edb4-4612-97ff-5a069db847c1,44015562,4683,3003,3000,3,30,30
406,d8facddc-edb4-4612-97ff-5a069db847c1,44008098,8202,434,1,433,0,53
406,d8facddc-edb4-4612-97ff-5a069db847c1,44008098,8202,672,450,222,2,53
406,d8facddc-edb4-4612-97ff-5a069db847c1,44008098,8202,673,673,0,3,53
406,d8facddc-edb4-4612-97ff-5a069db847c1,44008098,8202,871,677,194,4,53
406,d8facddc-edb4-4612-97ff-5a069db847c1,44008098,8202,1284,901,383,9,53
406,d8facddc-edb4-4612-97ff-5a069db847c1,44008098,8202,1390,1300,90,10,53
406,d8facddc-edb4-4612-97ff-5a069db847c1,44008098,8202,1897,1426,471,47,53
406,d8facddc-edb4-4612-97ff-5a069db847c1,44008098,8202,2922,1899,1023,48,53
406,d8facddc-edb4-4612-97ff-5a069db847c1,44008098,8202,3310,2925,385,49,53
406,d8facddc-edb4-4612-97ff-5a069db847c1,44008098,8202,3607,3324,283,50,53
406,d8facddc-edb4-4612-97ff-5a069db847c1,44008098,8202,3872,3627,245,51,53
406,d8facddc-edb4-4612-97ff-5a069db847c1,44008098,8202,5711,3875,1836,52,53
406,d8facddc-edb4-4612-97ff-5a069db847c1,44008098,8202,6522,5743,779,53,53
407,83192099-03ff-42ec-9b8a-ed68a9b16bd6,44019175,7293,150,12,138,0,19
407,83192099-03ff-42ec-9b8a-ed68a9b16bd6,44019175,7293,322,158,164,1,19
407,83192099-03ff-42ec-9b8a-ed68a9b16bd6,44019175,7293,656,329,327,2,19
407,83192099-03ff-42ec-9b8a-ed68a9b16bd6,44019175,7293,763,663,100,3,19
407,83192099-03ff-42ec-9b8a-ed68a9b16bd6,44019175,7293,913,765,148,4,19
407,83192099-03ff-42ec-9b8a-ed68a9b16bd6,44019175,7293,1038,938,100,5,19
407,83192099-03ff-42ec-9b8a-ed68a9b16bd6,44019175,7293,1150,1044,106,6,19
407,83192099-03ff-42ec-9b8a-ed68a9b16bd6,44019175,7293,1240,1159,81,7,19
407,83192099-03ff-42ec-9b8a-ed68a9b16bd6,44019175,7293,1345,1248,97,10,19
407,83192099-03ff-42ec-9b8a-ed68a9b16bd6,44019175,7293,1529,1361,168,11,19
407,83192099-03ff-42ec-9b8a-ed68a9b16bd6,44019175,7293,1821,1531,290,18,19
407,83192099-03ff-42ec-9b8a-ed68a9b16bd6,44019175,7293,2097,1854,243,19,19
407,83192099-03ff-42ec-9b8a-ed68a9b16bd6,43980567,6546,513,8,505,0,18
407,83192099-03ff-42ec-9b8a-ed68a9b16bd6,43980567,6546,633,521,112,1,18
407,83192099-03ff-42ec-9b8a-ed68a9b16bd6,43980567,6546,1265,668,597,2,18
407,83192099-03ff-42ec-9b8a-ed68a9b16bd6,43980567,6546,2956,1271,1685,3,18
407,83192099-03ff-42ec-9b8a-ed68a9b16bd6,43980567,6546,3542,3012,530,4,18
407,83192099-03ff-42ec-9b8a-ed68a9b16bd6,43980567,6546,4042,3555,487,6,18
407,83192099-03ff-42ec-9b8a-ed68a9b16bd6,43980567,6546,4687,4052,635,7,18
407,83192099-03ff-42ec-9b8a-ed68a9b16bd6,43980567,6546,5071,4708,363,8,18
407,83192099-03ff-42ec-9b8a-ed68a9b16bd6,43980567,6546,5166,5086,80,9,18
407,83192099-03ff-42ec-9b8a-ed68a9b16bd6,43980567,6546,5091,3636,-1455,10,18
407,83192099-03ff-42ec-9b8a-ed68a9b16bd6,43980567,6546,3603,347,-3256,11,18
407,83192099-03ff-42ec-9b8a-ed68a9b16bd6,43980567,6546,279,0,-279,12,18
407,83192099-03ff-42ec-9b8a-ed68a9b16bd6,43980567,6546,209,4,205,13,18
407,83192099-03ff-42ec-9b8a-ed68a9b16bd6,43980567,6546,336,227,109,14,18
407,83192099-03ff-42ec-9b8a-ed68a9b16bd6,43980567,6546,363,340,23,15,18
407,83192099-03ff-42ec-9b8a-ed68a9b16bd6,43980567,6546,394,364,30,17,18
407,83192099-03ff-42ec-9b8a-ed68a9b16bd6,43980567,6546,747,417,330,18,18
407,2f0bf9b1-c529-4153-bd49-20e9d46e33b1,44020235,16407,219,12,207,0,12
407,2f0bf9b1-c529-4153-bd49-20e9d46e33b1,44020235,16407,334,229,105,1,12
407,2f0bf9b1-c529-4153-bd49-20e9d46e33b1,44020235,16407,379,337,42,2,12
407,2f0bf9b1-c529-4153-bd49-20e9d46e33b1,44020235,16407,393,381,12,3,12
407,2f0bf9b1-c529-4153-bd49-20e9d46e33b1,44020235,16407,541,406,135,4,12
407,2f0bf9b1-c529-4153-bd49-20e9d46e33b1,44020235,16407,638,555,83,5,12
407,2f0bf9b1-c529-4153-bd49-20e9d46e33b1,44020235,16407,803,643,160,6,12
407,2f0bf9b1-c529-4153-bd49-20e9d46e33b1,44020235,16407,981,806,175,7,12
407,2f0bf9b1-c529-4153-bd49-20e9d46e33b1,44020235,16407,1415,992,423,8,12
407,2f0bf9b1-c529-4153-bd49-20e9d46e33b1,44020235,16407,2580,1426,1154,9,12
407,2f0bf9b1-c529-4153-bd49-20e9d46e33b1,44020235,16407,2898,2609,289,10,12
407,2f0bf9b1-c529-4153-bd49-20e9d46e33b1,44020235,16407,3001,2904,97,11,12
407,2f0bf9b1-c529-4153-bd49-20e9d46e33b1,44020235,16407,4085,3037,1048,12,12
407,2f0bf9b1-c529-4153-bd49-20e9d46e33b1,44021829,5754,96,2,94,0,19
407,2f0bf9b1-c529-4153-bd49-20e9d46e33b1,44021829,5754,239,99,140,1,19
407,2f0bf9b1-c529-4153-bd49-20e9d46e33b1,44021829,5754,325,247,78,2,19
407,2f0bf9b1-c529-4153-bd49-20e9d46e33b1,44021829,5754,548,328,220,3,19
407,2f0bf9b1-c529-4153-bd49-20e9d46e33b1,44021829,5754,629,554,75,4,19
407,2f0bf9b1-c529-4153-bd49-20e9d46e33b1,44021829,5754,1071,633,438,5,19
407,2f0bf9b1-c529-4153-bd49-20e9d46e33b1,44021829,5754,1097,1077,20,6,19
407,2f0bf9b1-c529-4153-bd49-20e9d46e33b1,44021829,5754,1592,1101,491,8,19
407,2f0bf9b1-c529-4153-bd49-20e9d46e33b1,44021829,5754,1730,1595,135,9,19
407,2f0bf9b1-c529-4153-bd49-20e9d46e33b1,44021829,5754,1849,1733,116,10,19
407,2f0bf9b1-c529-4153-bd49-20e9d46e33b1,44021829,5754,1953,1850,103,11,19
407,2f0bf9b1-c529-4153-bd49-20e9d46e33b1,44021829,5754,2076,1962,114,12,19
407,2f0bf9b1-c529-4153-bd49-20e9d46e33b1,44021829,5754,2281,2077,204,13,19
407,2f0bf9b1-c529-4153-bd49-20e9d46e33b1,44021829,5754,2334,2283,51,14,19
407,2f0bf9b1-c529-4153-bd49-20e9d46e33b1,44021829,5754,2492,2335,157,15,19
407,2f0bf9b1-c529-4153-bd49-20e9d46e33b1,44021829,5754,2579,2509,70,16,19
407,2f0bf9b1-c529-4153-bd49-20e9d46e33b1,44021829,5754,2611,2581,30,17,19
407,2f0bf9b1-c529-4153-bd49-20e9d46e33b1,44021829,5754,3259,2650,609,18,19
407,2f0bf9b1-c529-4153-bd49-20e9d46e33b1,44021829,5754,4374,3260,1114,19,19
407,2f0bf9b1-c529-4153-bd49-20e9d46e33b1,44021052,5850,299,19,280,0,37
407,2f0bf9b1-c529-4153-bd49-20e9d46e33b1,44021052,5850,341,307,34,1,37
407,2f0bf9b1-c529-4153-bd49-20e9d46e33b1,44021052,5850,495,353,142,3,37
407,2f0bf9b1-c529-4153-bd49-20e9d46e33b1,44021052,5850,600,499,101,4,37
407,2f0bf9b1-c529-4153-bd49-20e9d46e33b1,44021052,5850,648,603,45,5,37
407,2f0bf9b1-c529-4153-bd49-20e9d46e33b1,44021052,5850,705,660,45,6,37
407,2f0bf9b1-c529-4153-bd49-20e9d46e33b1,44021052,5850,742,710,32,7,37
407,2f0bf9b1-c529-4153-bd49-20e9d46e33b1,44021052,5850,737,640,-97,9,37
407,2f0bf9b1-c529-4153-bd49-20e9d46e33b1,44021052,5850,638,597,-41,10,37
407,2f0bf9b1-c529-4153-bd49-20e9d46e33b1,44021052,5850,647,600,47,12,37
407,2f0bf9b1-c529-4153-bd49-20e9d46e33b1,44021052,5850,684,649,35,13,37
407,2f0bf9b1-c529-4153-bd49-20e9d46e33b1,44021052,5850,857,692,165,14,37
407,2f0bf9b1-c529-4153-bd49-20e9d46e33b1,44021052,5850,907,868,39,15,37
407,2f0bf9b1-c529-4153-bd49-20e9d46e33b1,44021052,5850,1159,915,244,22,37
407,2f0bf9b1-c529-4153-bd49-20e9d46e33b1,44021052,5850,1501,1160,341,23,37
407,2f0bf9b1-c529-4153-bd49-20e9d46e33b1,44021052,5850,1679,1507,172,24,37
407,2f0bf9b1-c529-4153-bd49-20e9d46e33b1,44021052,5850,1813,1695,118,25,37
407,2f0bf9b1-c529-4153-bd49-20e9d46e33b1,44021052,5850,2342,1829,513,26,37
407,2f0bf9b1-c529-4153-bd49-20e9d46e33b1,44021052,5850,3308,2348,960,27,37
407,2f0bf9b1-c529-4153-bd49-20e9d46e33b1,44021052,5850,3383,3315,68,35,37
407,2f0bf9b1-c529-4153-bd49-20e9d46e33b1,44021052,5850,3491,3386,105,36,37
407,2f0bf9b1-c529-4153-bd49-20e9d46e33b1,44021052,5850,4044,3496,548,37,37
407,2f0bf9b1-c529-4153-bd49-20e9d46e33b1,44017046,8979,78,10,68,0,54
407,2f0bf9b1-c529-4153-bd49-20e9d46e33b1,44017046,8979,502,80,422,1,54
407,2f0bf9b1-c529-4153-bd49-20e9d46e33b1,44017046,8979,1054,506,548,2,54
407,2f0bf9b1-c529-4153-bd49-20e9d46e33b1,44017046,8979,1347,1065,282,3,54
407,2f0bf9b1-c529-4153-bd49-20e9d46e33b1,44017046,8979,1329,1197,-132,6,54
407,2f0bf9b1-c529-4153-bd49-20e9d46e33b1,44017046,8979,1189,1135,-54,7,54
407,2f0bf9b1-c529-4153-bd49-20e9d46e33b1,44017046,8979,1308,1039,269,8,54
407,2f0bf9b1-c529-4153-bd49-20e9d46e33b1,44017046,8979,1571,1337,234,9,54
407,2f0bf9b1-c529-4153-bd49-20e9d46e33b1,44017046,8979,1622,1576,46,10,54
407,2f0bf9b1-c529-4153-bd49-20e9d46e33b1,44017046,8979,1764,1628,136,11,54
407,2f0bf9b1-c529-4153-bd49-20e9d46e33b1,44017046,8979,1945,1768,177,12,54
407,2f0bf9b1-c529-4153-bd49-20e9d46e33b1,44017046,8979,2060,1948,112,13,54
407,2f0bf9b1-c529-4153-bd49-20e9d46e33b1,44017046,8979,2228,2071,157,14,54
407,2f0bf9b1-c529-4153-bd49-20e9d46e33b1,44017046,8979,2483,2229,254,15,54
407,2f0bf9b1-c529-4153-bd49-20e9d46e33b1,44017046,8979,2678,2485,193,16,54
407,2f0bf9b1-c529-4153-bd49-20e9d46e33b1,44017046,8979,2848,2689,159,17,54
407,2f0bf9b1-c529-4153-bd49-20e9d46e33b1,44017046,8979,2976,2854,122,18,54
407,2f0bf9b1-c529-4153-bd49-20e9d46e33b1,44017046,8979,3112,2989,123,19,54
407,2f0bf9b1-c529-4153-bd49-20e9d46e33b1,44017046,8979,3381,3122,259,20,54
407,2f0bf9b1-c529-4153-bd49-20e9d46e33b1,44017046,8979,3445,3393,52,21,54
407,2f0bf9b1-c529-4153-bd49-20e9d46e33b1,44017046,8979,3571,3446,125,22,54
407,2f0bf9b1-c529-4153-bd49-20e9d46e33b1,44017046,8979,3745,3584,161,23,54
407,2f0bf9b1-c529-4153-bd49-20e9d46e33b1,44017046,8979,3814,3749,65,24,54
407,2f0bf9b1-c529-4153-bd49-20e9d46e33b1,44017046,8979,3860,3818,42,26,54
407,2f0bf9b1-c529-4153-bd49-20e9d46e33b1,44017046,8979,3871,3863,8,29,54
407,2f0bf9b1-c529-4153-bd49-20e9d46e33b1,44017046,8979,3995,3875,120,30,54
407,2f0bf9b1-c529-4153-bd49-20e9d46e33b1,44017046,8979,4175,4013,162,31,54
407,2f0bf9b1-c529-4153-bd49-20e9d46e33b1,44017046,8979,4236,4185,51,32,54
407,2f0bf9b1-c529-4153-bd49-20e9d46e33b1,44017046,8979,4316,4244,72,48,54
407,2f0bf9b1-c529-4153-bd49-20e9d46e33b1,44017046,8979,4364,4331,33,49,54
407,2f0bf9b1-c529-4153-bd49-20e9d46e33b1,44017046,8979,4312,3569,-743,52,54
407,2f0bf9b1-c529-4153-bd49-20e9d46e33b1,44017046,8979,3472,2974,498,53,54
407,2f0bf9b1-c529-4153-bd49-20e9d46e33b1,44017046,8979,3454,2967,-487,54,54
407,2f0bf9b1-c529-4153-bd49-20e9d46e33b1,44017588,3726,198,10,188,0,52
407,2f0bf9b1-c529-4153-bd49-20e9d46e33b1,44017588,3726,430,209,221,8,52
407,2f0bf9b1-c529-4153-bd49-20e9d46e33b1,44017588,3726,766,443,323,13,52
407,2f0bf9b1-c529-4153-bd49-20e9d46e33b1,44017588,3726,886,767,119,15,52
407,2f0bf9b1-c529-4153-bd49-20e9d46e33b1,44017588,3726,896,890,6,16,52
407,2f0bf9b1-c529-4153-bd49-20e9d46e33b1,44017588,3726,1053,905,148,22,52
407,2f0bf9b1-c529-4153-bd49-20e9d46e33b1,44017588,3726,1236,1061,175,23,52
407,2f0bf9b1-c529-4153-bd49-20e9d46e33b1,44017588,3726,1443,1244,199,24,52
407,2f0bf9b1-c529-4153-bd49-20e9d46e33b1,44017588,3726,1449,1447,2,25,52
407,2f0bf9b1-c529-4153-bd49-20e9d46e33b1,44017588,3726,1565,1455,110,26,52
407,2f0bf9b1-c529-4153-bd49-20e9d46e33b1,44017588,3726,1651,1570,81,27,52
407,2f0bf9b1-c529-4153-bd49-20e9d46e33b1,44017588,3726,1834,1667,167,28,52
407,2f0bf9b1-c529-4153-bd49-20e9d46e33b1,44017588,3726,1914,1850,64,29,52
407,2f0bf9b1-c529-4153-bd49-20e9d46e33b1,44017588,3726,1994,1929,65,30,52
407,2f0bf9b1-c529-4153-bd49-20e9d46e33b1,44017588,3726,2060,2006,54,35,52
407,2f0bf9b1-c529-4153-bd49-20e9d46e33b1,44017588,3726,2124,2068,56,36,52
407,2f0bf9b1-c529-4153-bd49-20e9d46e33b1,44017588,3726,2125,2125,0,37,52
407,2f0bf9b1-c529-4153-bd49-20e9d46e33b1,44017588,3726,2346,2142,204,42,52
407,2f0bf9b1-c529-4153-bd49-20e9d46e33b1,44017588,3726,2342,2197,-145,51,52
407,2f0bf9b1-c529-4153-bd49-20e9d46e33b1,44017588,3726,2157,0,-2157,52,52
406,70e7a7d2-6e10-44de-8162-bc8611d65ee6,44020061,5187,1128,9,1119,0,33
406,70e7a7d2-6e10-44de-8162-bc8611d65ee6,44020061,5187,1148,1133,15,1,33
406,70e7a7d2-6e10-44de-8162-bc8611d65ee6,44020061,5187,1129,956,-173,2,33
406,70e7a7d2-6e10-44de-8162-bc8611d65ee6,44020061,5187,957,954,3,3,33
406,70e7a7d2-6e10-44de-8162-bc8611d65ee6,44020061,5187,990,958,32,4,33
406,70e7a7d2-6e10-44de-8162-bc8611d65ee6,44020061,5187,1813,993,820,5,33
406,70e7a7d2-6e10-44de-8162-bc8611d65ee6,44020061,5187,1939,1829,110,6,33
406,70e7a7d2-6e10-44de-8162-bc8611d65ee6,44020061,5187,2087,1959,128,10,33
406,70e7a7d2-6e10-44de-8162-bc8611d65ee6,44020061,5187,2154,2087,67,11,33
406,70e7a7d2-6e10-44de-8162-bc8611d65ee6,44020061,5187,2163,2155,8,12,33
406,70e7a7d2-6e10-44de-8162-bc8611d65ee6,44020061,5187,2198,2164,34,13,33
406,70e7a7d2-6e10-44de-8162-bc8611d65ee6,44020061,5187,2223,2198,25,14,33
406,70e7a7d2-6e10-44de-8162-bc8611d65ee6,44020061,5187,2225,2224,1,15,33
406,70e7a7d2-6e10-44de-8162-bc8611d65ee6,44020061,5187,2226,2226,0,19,33
406,70e7a7d2-6e10-44de-8162-bc8611d65ee6,44020061,5187,2877,2227,650,22,33
406,70e7a7d2-6e10-44de-8162-bc8611d65ee6,44020061,5187,3477,2879,598,32,33
406,70e7a7d2-6e10-44de-8162-bc8611d65ee6,44020061,5187,3507,3482,25,33,33
406,70e7a7d2-6e10-44de-8162-bc8611d65ee6,44017266,8613,391,27,364,0,108
406,70e7a7d2-6e10-44de-8162-bc8611d65ee6,44017266,8613,483,395,88,1,108
406,70e7a7d2-6e10-44de-8162-bc8611d65ee6,44017266,8613,534,498,36,2,108
406,70e7a7d2-6e10-44de-8162-bc8611d65ee6,44017266,8613,837,550,287,3,108
406,70e7a7d2-6e10-44de-8162-bc8611d65ee6,44017266,8613,949,839,110,9,108
406,70e7a7d2-6e10-44de-8162-bc8611d65ee6,44017266,8613,1211,969,242,10,108
406,70e7a7d2-6e10-44de-8162-bc8611d65ee6,44017266,8613,1549,1217,332,11,108
406,70e7a7d2-6e10-44de-8162-bc8611d65ee6,44017266,8613,1651,1557,94,19,108
406,70e7a7d2-6e10-44de-8162-bc8611d65ee6,44017266,8613,1670,1657,13,20,108
406,70e7a7d2-6e10-44de-8162-bc8611d65ee6,44017266,8613,1895,1677,218,25,108
406,70e7a7d2-6e10-44de-8162-bc8611d65ee6,44017266,8613,1996,1901,95,26,108
406,70e7a7d2-6e10-44de-8162-bc8611d65ee6,44017266,8613,2222,2005,217,27,108
406,70e7a7d2-6e10-44de-8162-bc8611d65ee6,44017266,8613,2249,2224,25,32,108
406,70e7a7d2-6e10-44de-8162-bc8611d65ee6,44017266,8613,2477,2252,225,33,108
406,70e7a7d2-6e10-44de-8162-bc8611d65ee6,44017266,8613,2471,2371,-100,34,108
406,70e7a7d2-6e10-44de-8162-bc8611d65ee6,44017266,8613,2365,2341,-24,35,108
406,70e7a7d2-6e10-44de-8162-bc8611d65ee6,44017266,8613,2513,2346,167,39,108
406,70e7a7d2-6e10-44de-8162-bc8611d65ee6,44017266,8613,2691,2520,171,40,108
406,70e7a7d2-6e10-44de-8162-bc8611d65ee6,44017266,8613,2798,2695,103,45,108
406,70e7a7d2-6e10-44de-8162-bc8611d65ee6,44017266,8613,3489,2804,685,46,108
406,70e7a7d2-6e10-44de-8162-bc8611d65ee6,44017266,8613,4562,3490,1072,47,108
406,70e7a7d2-6e10-44de-8162-bc8611d65ee6,44017266,8613,5260,4399,861,48,108
406,70e7a7d2-6e10-44de-8162-bc8611d65ee6,44017266,8613,5247,4780,-467,49,108
406,70e7a7d2-6e10-44de-8162-bc8611d65ee6,44017266,8613,4774,4446,-328,50,108
406,70e7a7d2-6e10-44de-8162-bc8611d65ee6,44017266,8613,4441,4403,-38,51,108
406,70e7a7d2-6e10-44de-8162-bc8611d65ee6,44017266,8613,4493,4416,77,71,108
406,70e7a7d2-6e10-44de-8162-bc8611d65ee6,44017266,8613,4820,4501,319,72,108
406,70e7a7d2-6e10-44de-8162-bc8611d65ee6,44017266,8613,4916,4827,89,76,108
406,70e7a7d2-6e10-44de-8162-bc8611d65ee6,44017266,8613,5148,4917,231,77,108
406,70e7a7d2-6e10-44de-8162-bc8611d65ee6,44017266,8613,5716,5150,566,78,108
406,70e7a7d2-6e10-44de-8162-bc8611d65ee6,44017266,8613,5758,5723,35,79,108
406,70e7a7d2-6e10-44de-8162-bc8611d65ee6,44017266,8613,5943,5759,184,80,108
406,70e7a7d2-6e10-44de-8162-bc8611d65ee6,44017266,8613,6120,5966,154,81,108
406,70e7a7d2-6e10-44de-8162-bc8611d65ee6,44017266,8613,6119,5810,-309,82,108
406,70e7a7d2-6e10-44de-8162-bc8611d65ee6,44017266,8613,5812,5798,14,83,108
406,70e7a7d2-6e10-44de-8162-bc8611d65ee6,44017266,8613,5915,5817,98,85,108
406,70e7a7d2-6e10-44de-8162-bc8611d65ee6,44017266,8613,6110,5920,190,86,108
406,70e7a7d2-6e10-44de-8162-bc8611d65ee6,44017266,8613,6580,6113,467,98,108
406,70e7a7d2-6e10-44de-8162-bc8611d65ee6,44017266,8613,6796,6584,212,107,108
406,70e7a7d2-6e10-44de-8162-bc8611d65ee6,44017266,8613,6933,6818,115,108,108
408,21fdce87-e698-49c7-bf62-7aa2ac03220c,43995168,3097,72,0,-72,0,11
408,21fdce87-e698-49c7-bf62-7aa2ac03220c,43995168,3097,96,1,95,1,11
408,21fdce87-e698-49c7-bf62-7aa2ac03220c,43995168,3097,655,102,553,2,11
408,21fdce87-e698-49c7-bf62-7aa2ac03220c,43995168,3097,1274,673,601,3,11
408,21fdce87-e698-49c7-bf62-7aa2ac03220c,43995168,3097,2337,1304,1033,4,11
408,21fdce87-e698-49c7-bf62-7aa2ac03220c,43995168,3097,2335,1793,-542,7,11
408,21fdce87-e698-49c7-bf62-7aa2ac03220c,43995168,3097,1770,976,-794,8,11
408,21fdce87-e698-49c7-bf62-7aa2ac03220c,43995168,3097,958,275,-683,9,11
408,21fdce87-e698-49c7-bf62-7aa2ac03220c,43995168,3097,267,69,-198,10,11
408,21fdce87-e698-49c7-bf62-7aa2ac03220c,43995168,3097,61,0,-61,11,11
408,21fdce87-e698-49c7-bf62-7aa2ac03220c,44005724,3276,57,1,56,0,5
408,21fdce87-e698-49c7-bf62-7aa2ac03220c,44005724,3276,130,59,71,1,5
408,21fdce87-e698-49c7-bf62-7aa2ac03220c,44005724,3276,419,146,273,2,5
408,21fdce87-e698-49c7-bf62-7aa2ac03220c,44005724,3276,1115,445,670,3,5
408,21fdce87-e698-49c7-bf62-7aa2ac03220c,44005724,3276,1348,1117,231,4,5
408,21fdce87-e698-49c7-bf62-7aa2ac03220c,44005724,3276,2516,1392,1124,5,5
408,21fdce87-e698-49c7-bf62-7aa2ac03220c,44021829,2932,21,3,18,0,35
408,21fdce87-e698-49c7-bf62-7aa2ac03220c,44021829,2932,145,23,122,1,35
408,21fdce87-e698-49c7-bf62-7aa2ac03220c,44021829,2932,257,146,111,2,35
408,21fdce87-e698-49c7-bf62-7aa2ac03220c,44021829,2932,402,267,135,3,35
408,21fdce87-e698-49c7-bf62-7aa2ac03220c,44021829,2932,405,403,2,4,35
408,21fdce87-e698-49c7-bf62-7aa2ac03220c,44021829,2932,464,406,58,5,35
408,21fdce87-e698-49c7-bf62-7aa2ac03220c,44021829,2932,523,466,57,6,35
408,21fdce87-e698-49c7-bf62-7aa2ac03220c,44021829,2932,584,524,60,7,35
408,21fdce87-e698-49c7-bf62-7aa2ac03220c,44021829,2932,631,586,45,11,35
408,21fdce87-e698-49c7-bf62-7aa2ac03220c,44021829,2932,846,635,211,17,35
408,21fdce87-e698-49c7-bf62-7aa2ac03220c,44021829,2932,844,646,-198,19,35
408,21fdce87-e698-49c7-bf62-7aa2ac03220c,44021829,2932,823,650,173,25,35
408,21fdce87-e698-49c7-bf62-7aa2ac03220c,44021829,2932,1069,830,239,26,35
408,21fdce87-e698-49c7-bf62-7aa2ac03220c,44021829,2932,1873,0,-1873,27,35
408,21fdce87-e698-49c7-bf62-7aa2ac03220c,44021829,9592,156,156,0,30,35
408,21fdce87-e698-49c7-bf62-7aa2ac03220c,44021829,11520,929,167,762,31,35
408,21fdce87-e698-49c7-bf62-7aa2ac03220c,44021829,13597,817,755,-62,32,35
408,21fdce87-e698-49c7-bf62-7aa2ac03220c,44021829,13597,753,526,-227,33,35
408,21fdce87-e698-49c7-bf62-7aa2ac03220c,44021829,16302,1072,537,535,35,35
406,f7731d6e-7886-4695-8fd7-36f170dc6562,44007709,2907,285,16,269,0,41
406,f7731d6e-7886-4695-8fd7-36f170dc6562,44007709,2907,983,312,671,1,41
406,f7731d6e-7886-4695-8fd7-36f170dc6562,44007709,2907,1038,986,52,18,41
406,f7731d6e-7886-4695-8fd7-36f170dc6562,44007709,2907,1038,1034,4,19,41
406,f7731d6e-7886-4695-8fd7-36f170dc6562,44007709,2907,1040,1039,1,20,41
406,f7731d6e-7886-4695-8fd7-36f170dc6562,44007709,2907,1181,1051,130,26,41
406,f7731d6e-7886-4695-8fd7-36f170dc6562,44007709,2907,1216,1191,25,27,41
406,f7731d6e-7886-4695-8fd7-36f170dc6562,44007709,2907,1227,1218,9,39,41
406,f7731d6e-7886-4695-8fd7-36f170dc6562,44007709,2907,1226,924,-302,40,41
406,f7731d6e-7886-4695-8fd7-36f170dc6562,44007709,2907,928,916,12,41,41
406,f7731d6e-7886-4695-8fd7-36f170dc6562,43987148,6576,308,3,305,0,103
406,f7731d6e-7886-4695-8fd7-36f170dc6562,43987148,6576,723,310,413,1,103
406,f7731d6e-7886-4695-8fd7-36f170dc6562,43987148,6576,1283,729,554,2,103
406,f7731d6e-7886-4695-8fd7-36f170dc6562,43987148,6576,1678,1309,369,22,103
406,f7731d6e-7886-4695-8fd7-36f170dc6562,43987148,6576,1676,1675,-1,23,103
406,f7731d6e-7886-4695-8fd7-36f170dc6562,43987148,6576,1676,1675,1,23,103
406,f7731d6e-7886-4695-8fd7-36f170dc6562,43987148,6576,2080,1700,380,43,103
406,f7731d6e-7886-4695-8fd7-36f170dc6562,43987148,6576,2577,2096,481,44,103
406,f7731d6e-7886-4695-8fd7-36f170dc6562,43987148,6576,2964,2605,359,62,103
406,f7731d6e-7886-4695-8fd7-36f170dc6562,43987148,6576,3055,2969,86,63,103
406,f7731d6e-7886-4695-8fd7-36f170dc6562,43987148,6576,3660,3090,570,67,103
406,f7731d6e-7886-4695-8fd7-36f170dc6562,43987148,6576,3685,3665,20,68,103
406,f7731d6e-7886-4695-8fd7-36f170dc6562,43987148,6576,3945,3748,197,71,103
406,f7731d6e-7886-4695-8fd7-36f170dc6562,43987148,6576,4330,3961,369,72,103
406,f7731d6e-7886-4695-8fd7-36f170dc6562,43987148,6576,4896,4364,532,77,103
406,f7731d6e-7886-4695-8fd7-36f170dc6562,43987148,6576,4854,4762,-92,87,103
406,f7731d6e-7886-4695-8fd7-36f170dc6562,43987148,6576,4793,4727,66,88,103
406,f7731d6e-7886-4695-8fd7-36f170dc6562,43987148,6576,4807,4795,12,89,103
406,f7731d6e-7886-4695-8fd7-36f170dc6562,43987148,6576,4772,4132,-640,103,103
406,f7731d6e-7886-4695-8fd7-36f170dc6562,44021119,14061,1204,72,1132,0,187
406,f7731d6e-7886-4695-8fd7-36f170dc6562,44021119,14061,1415,1148,-267,1,187
406,f7731d6e-7886-4695-8fd7-36f170dc6562,44021119,14061,1097,710,-387,2,187
406,f7731d6e-7886-4695-8fd7-36f170dc6562,44021119,14061,661,329,-332,6,187
406,f7731d6e-7886-4695-8fd7-36f170dc6562,44021119,14061,326,0,-326,7,187
406,f7731d6e-7886-4695-8fd7-36f170dc6562,44021119,14061,65,5,60,8,187
406,f7731d6e-7886-4695-8fd7-36f170dc6562,44021119,14061,625,59,566,9,187
406,f7731d6e-7886-4695-8fd7-36f170dc6562,44021119,14061,626,622,4,10,187
406,f7731d6e-7886-4695-8fd7-36f170dc6562,44021119,14061,634,627,7,11,187
406,f7731d6e-7886-4695-8fd7-36f170dc6562,44021119,14061,679,635,44,12,187
406,f7731d6e-7886-4695-8fd7-36f170dc6562,44021119,14061,718,678,40,13,187
406,f7731d6e-7886-4695-8fd7-36f170dc6562,44021119,14061,981,732,249,14,187
406,f7731d6e-7886-4695-8fd7-36f170dc6562,44021119,14061,1965,983,982,15,187
406,f7731d6e-7886-4695-8fd7-36f170dc6562,44021119,14061,2230,2005,225,32,187
406,f7731d6e-7886-4695-8fd7-36f170dc6562,44021119,14061,2331,2244,87,34,187
406,f7731d6e-7886-4695-8fd7-36f170dc6562,44021119,14061,2551,2334,217,35,187
406,f7731d6e-7886-4695-8fd7-36f170dc6562,44021119,14061,2578,2552,26,36,187
406,f7731d6e-7886-4695-8fd7-36f170dc6562,44021119,14061,2572,2571,1,37,187
406,f7731d6e-7886-4695-8fd7-36f170dc6562,44021119,14061,2572,2571,-1,37,187
406,f7731d6e-7886-4695-8fd7-36f170dc6562,44021119,14061,2587,2570,17,38,187
406,f7731d6e-7886-4695-8fd7-36f170dc6562,44021119,14061,2625,2589,36,39,187
406,f7731d6e-7886-4695-8fd7-36f170dc6562,44021119,14061,2638,2626,12,40,187
406,f7731d6e-7886-4695-8fd7-36f170dc6562,44021119,14061,2651,2637,14,41,187
406,f7731d6e-7886-4695-8fd7-36f170dc6562,44021119,14061,3141,2652,489,42,187
406,f7731d6e-7886-4695-8fd7-36f170dc6562,44021119,14061,4278,3173,1105,43,187
406,f7731d6e-7886-4695-8fd7-36f170dc6562,44021119,14061,4382,4290,92,44,187
406,f7731d6e-7886-4695-8fd7-36f170dc6562,44021119,14061,4448,4384,64,45,187
406,f7731d6e-7886-4695-8fd7-36f170dc6562,44021119,14061,4813,4460,353,54,187
406,f7731d6e-7886-4695-8fd7-36f170dc6562,44021119,14061,4998,4838,160,55,187
406,f7731d6e-7886-4695-8fd7-36f170dc6562,44021119,14061,5006,5001,5,56,187
406,f7731d6e-7886-4695-8fd7-36f170dc6562,44021119,14061,5222,5015,207,58,187
406,f7731d6e-7886-4695-8fd7-36f170dc6562,44021119,14061,5822,5224,598,59,187
406,f7731d6e-7886-4695-8fd7-36f170dc6562,44021119,14061,6241,5831,410,60,187
406,f7731d6e-7886-4695-8fd7-36f170dc6562,44021119,14061,6516,6253,263,61,187
406,f7731d6e-7886-4695-8fd7-36f170dc6562,44021119,14061,6615,6524,91,80,187
406,f7731d6e-7886-4695-8fd7-36f170dc6562,44021119,14061,6823,6623,200,81,187
406,f7731d6e-7886-4695-8fd7-36f170dc6562,44021119,14061,7005,6833,172,82,187
406,f7731d6e-7886-4695-8fd7-36f170dc6562,44021119,14061,7082,7034,48,110,187
406,f7731d6e-7886-4695-8fd7-36f170dc6562,44021119,14061,7528,7116,412,111,187
406,f7731d6e-7886-4695-8fd7-36f170dc6562,44021119,14061,7736,7529,207,112,187
406,f7731d6e-7886-4695-8fd7-36f170dc6562,44021119,14061,7735,7733,-2,113,187
406,f7731d6e-7886-4695-8fd7-36f170dc6562,44021119,14061,7800,7737,63,119,187
406,f7731d6e-7886-4695-8fd7-36f170dc6562,44021119,14061,8223,7821,402,126,187
406,f7731d6e-7886-4695-8fd7-36f170dc6562,44021119,14061,8749,8234,515,127,187
406,f7731d6e-7886-4695-8fd7-36f170dc6562,44021119,14061,9152,8762,390,132,187
406,f7731d6e-7886-4695-8fd7-36f170dc6562,44021119,14061,9245,9160,85,133,187
406,f7731d6e-7886-4695-8fd7-36f170dc6562,44021119,14061,9313,9313,0,135,187
406,f7731d6e-7886-4695-8fd7-36f170dc6562,44021119,14061,9573,9382,191,136,187
406,f7731d6e-7886-4695-8fd7-36f170dc6562,44021119,14061,9882,9627,255,139,187
406,f7731d6e-7886-4695-8fd7-36f170dc6562,44021119,14061,10043,9912,131,144,187
406,f7731d6e-7886-4695-8fd7-36f170dc6562,44021119,14061,10041,10041,0,145,187
406,f7731d6e-7886-4695-8fd7-36f170dc6562,44021119,14061,10250,10059,191,149,187
406,f7731d6e-7886-4695-8fd7-36f170dc6562,44021119,14061,10599,10251,348,154,187
406,f7731d6e-7886-4695-8fd7-36f170dc6562,44021119,14061,10900,10612,288,156,187
406,f7731d6e-7886-4695-8fd7-36f170dc6562,44021119,14061,11015,10910,105,157,187
406,f7731d6e-7886-4695-8fd7-36f170dc6562,44021119,14061,11345,11014,331,158,187
406,f7731d6e-7886-4695-8fd7-36f170dc6562,44021119,14061,11445,11350,95,159,187
406,f7731d6e-7886-4695-8fd7-36f170dc6562,44021119,14061,11560,11462,98,164,187
406,f7731d6e-7886-4695-8fd7-36f170dc6562,44021119,14061,11636,11560,76,165,187
406,f7731d6e-7886-4695-8fd7-36f170dc6562,44021119,14061,11888,11638,250,169,187
406,f7731d6e-7886-4695-8fd7-36f170dc6562,44021119,14061,12135,11928,207,170,187
406,f7731d6e-7886-4695-8fd7-36f170dc6562,44021119,14061,12381,12139,242,171,187
406,f7731d6e-7886-4695-8fd7-36f170dc6562,44021119,14061,12381,12380,1,172,187
406,f7731d6e-7886-4695-8fd7-36f170dc6562,44021119,14061,12374,12337,-37,181,187
406,f7731d6e-7886-4695-8fd7-36f170dc6562,44021119,14061,12324,11617,-707,186,187
406,f7731d6e-7886-4695-8fd7-36f170dc6562,44021119,14061,11560,10909,-651,187,187
407,8e68de20-e181-42c9-95bd-4a6fd890f4a9,44026796,8742,161,3,158,0,25
407,8e68de20-e181-42c9-95bd-4a6fd890f4a9,44026796,8742,236,169,67,1,25
407,8e68de20-e181-42c9-95bd-4a6fd890f4a9,44026796,8742,253,239,14,2,25
407,8e68de20-e181-42c9-95bd-4a6fd890f4a9,44026796,8742,376,255,121,3,25
407,8e68de20-e181-42c9-95bd-4a6fd890f4a9,44026796,8742,546,383,163,4,25
407,8e68de20-e181-42c9-95bd-4a6fd890f4a9,44026796,8742,619,550,69,5,25
407,8e68de20-e181-42c9-95bd-4a6fd890f4a9,44026796,8742,726,621,105,6,25
407,8e68de20-e181-42c9-95bd-4a6fd890f4a9,44026796,8742,803,734,69,7,25
407,8e68de20-e181-42c9-95bd-4a6fd890f4a9,44026796,8742,1030,804,226,8,25
407,8e68de20-e181-42c9-95bd-4a6fd890f4a9,44026796,8742,1115,1035,80,9,25
407,8e68de20-e181-42c9-95bd-4a6fd890f4a9,44026796,8742,1555,1132,423,10,25
407,8e68de20-e181-42c9-95bd-4a6fd890f4a9,44026796,8742,1664,1559,105,11,25
407,8e68de20-e181-42c9-95bd-4a6fd890f4a9,44026796,8742,1738,1668,70,12,25
407,8e68de20-e181-42c9-95bd-4a6fd890f4a9,44026796,8742,1793,1739,54,13,25
407,8e68de20-e181-42c9-95bd-4a6fd890f4a9,44026796,8742,2128,1799,329,14,25
407,8e68de20-e181-42c9-95bd-4a6fd890f4a9,44026796,8742,2783,2130,653,15,25
407,8e68de20-e181-42c9-95bd-4a6fd890f4a9,44026796,8742,2844,2788,56,16,25
407,8e68de20-e181-42c9-95bd-4a6fd890f4a9,44026796,8742,2872,2848,24,17,25
407,8e68de20-e181-42c9-95bd-4a6fd890f4a9,44026796,8742,2883,2876,7,18,25
407,8e68de20-e181-42c9-95bd-4a6fd890f4a9,44026796,8742,2909,2885,24,19,25
407,8e68de20-e181-42c9-95bd-4a6fd890f4a9,44026796,8742,3068,2919,149,21,25
407,8e68de20-e181-42c9-95bd-4a6fd890f4a9,44026796,8742,3598,3075,523,22,25
407,8e68de20-e181-42c9-95bd-4a6fd890f4a9,44026796,8742,3683,3599,84,23,25
407,8e68de20-e181-42c9-95bd-4a6fd890f4a9,44026796,8742,3721,3693,28,24,25
407,8e68de20-e181-42c9-95bd-4a6fd890f4a9,44026796,8742,3808,0,-3808,25,25
407,8e68de20-e181-42c9-95bd-4a6fd890f4a9,43939015,26175,113,0,-113,0,20
407,8e68de20-e181-42c9-95bd-4a6fd890f4a9,43939015,26175,565,7,558,2,20
407,8e68de20-e181-42c9-95bd-4a6fd890f4a9,43939015,26175,999,607,392,3,20
407,8e68de20-e181-42c9-95bd-4a6fd890f4a9,43939015,26175,1182,1001,181,4,20
407,8e68de20-e181-42c9-95bd-4a6fd890f4a9,43939015,26175,1936,1186,750,5,20
407,8e68de20-e181-42c9-95bd-4a6fd890f4a9,43939015,26175,1951,1180,-771,6,20
407,8e68de20-e181-42c9-95bd-4a6fd890f4a9,43939015,26175,1178,1177,-1,7,20
407,8e68de20-e181-42c9-95bd-4a6fd890f4a9,43939015,26175,1146,657,-489,17,20
407,8e68de20-e181-42c9-95bd-4a6fd890f4a9,43939015,26175,638,0,-638,18,20
407,8e68de20-e181-42c9-95bd-4a6fd890f4a9,43939015,26175,932,4,928,19,20
407,8e68de20-e181-42c9-95bd-4a6fd890f4a9,43939015,26175,959,939,20,20,20
407,8e68de20-e181-42c9-95bd-4a6fd890f4a9,44023381,5217,272,11,261,0,29
407,8e68de20-e181-42c9-95bd-4a6fd890f4a9,44023381,5217,401,284,117,1,29
407,8e68de20-e181-42c9-95bd-4a6fd890f4a9,44023381,5217,444,409,35,2,29
407,8e68de20-e181-42c9-95bd-4a6fd890f4a9,44023381,5217,468,447,21,3,29
407,8e68de20-e181-42c9-95bd-4a6fd890f4a9,44023381,5217,572,471,101,10,29
407,8e68de20-e181-42c9-95bd-4a6fd890f4a9,44023381,5217,675,579,96,11,29
407,8e68de20-e181-42c9-95bd-4a6fd890f4a9,44023381,5217,696,679,17,12,29
407,8e68de20-e181-42c9-95bd-4a6fd890f4a9,44023381,5217,726,698,28,16,29
407,8e68de20-e181-42c9-95bd-4a6fd890f4a9,44023381,5217,734,728,6,17,29
407,8e68de20-e181-42c9-95bd-4a6fd890f4a9,44023381,5217,765,736,29,18,29
407,8e68de20-e181-42c9-95bd-4a6fd890f4a9,44023381,5217,916,774,142,19,29
407,8e68de20-e181-42c9-95bd-4a6fd890f4a9,44023381,5217,1261,927,334,20,29
407,8e68de20-e181-42c9-95bd-4a6fd890f4a9,44023381,5217,1511,1272,239,21,29
407,8e68de20-e181-42c9-95bd-4a6fd890f4a9,44023381,5217,1578,1514,64,22,29
407,8e68de20-e181-42c9-95bd-4a6fd890f4a9,44023381,5217,1627,1585,42,23,29
407,8e68de20-e181-42c9-95bd-4a6fd890f4a9,44023381,5217,1677,1628,49,24,29
407,8e68de20-e181-42c9-95bd-4a6fd890f4a9,44023381,5217,2203,1683,520,25,29
407,8e68de20-e181-42c9-95bd-4a6fd890f4a9,44023381,5217,2744,2214,530,26,29
407,8e68de20-e181-42c9-95bd-4a6fd890f4a9,44023381,5217,3353,2747,606,27,29
407,8e68de20-e181-42c9-95bd-4a6fd890f4a9,44023381,5217,3708,3358,350,28,29
407,8e68de20-e181-42c9-95bd-4a6fd890f4a9,44023381,5217,3837,3714,123,29,29
407,a968156b-94ac-4274-9a76-b2310e8f8822,44028663,8073,849,7,842,0,12
407,a968156b-94ac-4274-9a76-b2310e8f8822,44028663,8073,921,861,60,1,12
407,a968156b-94ac-4274-9a76-b2310e8f8822,44028663,8073,1078,931,147,2,12
407,a968156b-94ac-4274-9a76-b2310e8f8822,44028663,8073,1128,1082,46,3,12
407,a968156b-94ac-4274-9a76-b2310e8f8822,44028663,8073,1350,1134,216,4,12
407,a968156b-94ac-4274-9a76-b2310e8f8822,44028663,8073,1826,1361,465,5,12
407,a968156b-94ac-4274-9a76-b2310e8f8822,44028663,8073,2050,1830,220,6,12
407,a968156b-94ac-4274-9a76-b2310e8f8822,44028663,8073,2520,2066,454,7,12
407,a968156b-94ac-4274-9a76-b2310e8f8822,44028663,8073,3313,2526,787,8,12
407,a968156b-94ac-4274-9a76-b2310e8f8822,44028663,8073,4049,3320,729,9,12
407,a968156b-94ac-4274-9a76-b2310e8f8822,44028663,8073,5072,4052,1020,10,12
407,a968156b-94ac-4274-9a76-b2310e8f8822,44028663,8073,5579,5106,473,11,12
407,a968156b-94ac-4274-9a76-b2310e8f8822,44028663,8073,5871,5585,286,12,12
407,fed87984-63c4-4486-a6d5-2610c192cfad,44017266,8613,2,2,0,0,17
407,fed87984-63c4-4486-a6d5-2610c192cfad,44017266,8613,100,8,92,1,17
407,fed87984-63c4-4486-a6d5-2610c192cfad,44017266,8613,684,101,583,2,17
407,fed87984-63c4-4486-a6d5-2610c192cfad,44017266,8613,811,688,123,3,17
407,fed87984-63c4-4486-a6d5-2610c192cfad,44017266,8613,889,820,69,4,17
407,fed87984-63c4-4486-a6d5-2610c192cfad,44017266,8613,1135,891,244,5,17
407,fed87984-63c4-4486-a6d5-2610c192cfad,44017266,8613,1304,1138,166,6,17
407,fed87984-63c4-4486-a6d5-2610c192cfad,44017266,8613,1424,1312,112,7,17
407,fed87984-63c4-4486-a6d5-2610c192cfad,44017266,8613,1983,1428,555,8,17
407,fed87984-63c4-4486-a6d5-2610c192cfad,44017266,8613,2471,1986,485,9,17
407,fed87984-63c4-4486-a6d5-2610c192cfad,44017266,8613,2555,2487,68,10,17
407,fed87984-63c4-4486-a6d5-2610c192cfad,44017266,8613,2870,2562,308,13,17
407,fed87984-63c4-4486-a6d5-2610c192cfad,44017266,8613,3763,2930,833,14,17
407,fed87984-63c4-4486-a6d5-2610c192cfad,44017266,8613,5055,3800,1255,15,17
407,fed87984-63c4-4486-a6d5-2610c192cfad,44017266,8613,6041,5056,985,16,17
407,fed87984-63c4-4486-a6d5-2610c192cfad,44017266,8613,7233,6078,1155,17,17
407,fed87984-63c4-4486-a6d5-2610c192cfad,43992782,7890,331,13,318,0,34
407,fed87984-63c4-4486-a6d5-2610c192cfad,43992782,7890,424,343,81,1,34
407,fed87984-63c4-4486-a6d5-2610c192cfad,43992782,7890,491,429,62,2,34
407,fed87984-63c4-4486-a6d5-2610c192cfad,43992782,7890,532,492,40,3,34
407,fed87984-63c4-4486-a6d5-2610c192cfad,43992782,7890,567,533,34,5,34
407,fed87984-63c4-4486-a6d5-2610c192cfad,43992782,7890,844,583,261,6,34
407,fed87984-63c4-4486-a6d5-2610c192cfad,43992782,7890,918,845,73,7,34
407,fed87984-63c4-4486-a6d5-2610c192cfad,43992782,7890,1298,936,362,8,34
407,fed87984-63c4-4486-a6d5-2610c192cfad,43992782,7890,1882,1341,541,9,34
407,fed87984-63c4-4486-a6d5-2610c192cfad,43992782,7890,2330,1918,412,10,34
407,fed87984-63c4-4486-a6d5-2610c192cfad,43992782,7890,2400,2332,68,15,34
407,fed87984-63c4-4486-a6d5-2610c192cfad,43992782,7890,2561,2402,159,16,34
407,fed87984-63c4-4486-a6d5-2610c192cfad,43992782,7890,2745,2569,176,17,34
407,fed87984-63c4-4486-a6d5-2610c192cfad,43992782,7890,2913,2751,162,18,34
407,fed87984-63c4-4486-a6d5-2610c192cfad,43992782,7890,3004,2914,90,19,34
407,fed87984-63c4-4486-a6d5-2610c192cfad,43992782,7890,3066,3010,56,20,34
407,fed87984-63c4-4486-a6d5-2610c192cfad,43992782,7890,3164,3069,95,21,34
407,fed87984-63c4-4486-a6d5-2610c192cfad,43992782,7890,3258,3173,85,22,34
407,fed87984-63c4-4486-a6d5-2610c192cfad,43992782,7890,3360,3265,95,23,34
407,fed87984-63c4-4486-a6d5-2610c192cfad,43992782,7890,3428,3369,59,24,34
407,fed87984-63c4-4486-a6d5-2610c192cfad,43992782,7890,3595,3440,155,25,34
407,fed87984-63c4-4486-a6d5-2610c192cfad,43992782,7890,3726,3602,124,26,34
407,fed87984-63c4-4486-a6d5-2610c192cfad,43992782,7890,3728,3727,1,27,34
407,fed87984-63c4-4486-a6d5-2610c192cfad,43992782,7890,3830,3736,94,28,34
407,fed87984-63c4-4486-a6d5-2610c192cfad,43992782,7890,3883,3836,47,29,34
407,fed87984-63c4-4486-a6d5-2610c192cfad,43992782,7890,5335,3890,1445,30,34
407,fed87984-63c4-4486-a6d5-2610c192cfad,43992782,7890,6496,5397,1099,31,34
407,fed87984-63c4-4486-a6d5-2610c192cfad,43992782,7890,6510,6510,0,32,34
407,fed87984-63c4-4486-a6d5-2610c192cfad,43992782,7890,6479,6287,-192,34,34
406,ee13fd8e-9627-402e-9d3e-07d6f09c8597,44023381,5217,79,2,77,0,61
406,ee13fd8e-9627-402e-9d3e-07d6f09c8597,44023381,5217,165,79,86,1,61
406,ee13fd8e-9627-402e-9d3e-07d6f09c8597,44023381,5217,507,180,327,2,61
406,ee13fd8e-9627-402e-9d3e-07d6f09c8597,44023381,5217,517,517,0,11,61
406,ee13fd8e-9627-402e-9d3e-07d6f09c8597,44023381,5217,559,519,40,12,61
406,ee13fd8e-9627-402e-9d3e-07d6f09c8597,44023381,5217,673,557,116,13,61
406,ee13fd8e-9627-402e-9d3e-07d6f09c8597,44023381,5217,1033,683,350,14,61
406,ee13fd8e-9627-402e-9d3e-07d6f09c8597,44023381,5217,1255,1039,216,35,61
406,ee13fd8e-9627-402e-9d3e-07d6f09c8597,44023381,5217,1477,1258,219,40,61
406,ee13fd8e-9627-402e-9d3e-07d6f09c8597,44023381,5217,1558,1481,77,41,61
406,ee13fd8e-9627-402e-9d3e-07d6f09c8597,44023381,5217,1648,1559,89,49,61
406,ee13fd8e-9627-402e-9d3e-07d6f09c8597,44023381,5217,2108,1656,452,50,61
406,ee13fd8e-9627-402e-9d3e-07d6f09c8597,44023381,5217,2100,1962,-138,51,61
406,ee13fd8e-9627-402e-9d3e-07d6f09c8597,44023381,5217,2152,1980,172,54,61
406,ee13fd8e-9627-402e-9d3e-07d6f09c8597,44023381,5217,2441,2168,273,55,61
406,ee13fd8e-9627-402e-9d3e-07d6f09c8597,44023381,5217,2683,2452,231,60,61
406,ee13fd8e-9627-402e-9d3e-07d6f09c8597,44023381,5217,3537,2700,837,61,61
406,ee13fd8e-9627-402e-9d3e-07d6f09c8597,44017266,8067,249,18,231,0,135
406,ee13fd8e-9627-402e-9d3e-07d6f09c8597,44017266,8067,463,256,207,1,135
406,ee13fd8e-9627-402e-9d3e-07d6f09c8597,44017266,8067,553,468,85,2,135
406,ee13fd8e-9627-402e-9d3e-07d6f09c8597,44017266,8067,711,555,156,3,135
406,ee13fd8e-9627-402e-9d3e-07d6f09c8597,44017266,8067,886,717,169,10,135
406,ee13fd8e-9627-402e-9d3e-07d6f09c8597,44017266,8067,1014,891,123,11,135
406,ee13fd8e-9627-402e-9d3e-07d6f09c8597,44017266,8067,1093,1018,75,13,135
406,ee13fd8e-9627-402e-9d3e-07d6f09c8597,44017266,8067,1102,1094,8,14,135
406,ee13fd8e-9627-402e-9d3e-07d6f09c8597,44017266,8067,1180,1104,76,15,135
406,ee13fd8e-9627-402e-9d3e-07d6f09c8597,44017266,8067,1369,1181,188,16,135
406,ee13fd8e-9627-402e-9d3e-07d6f09c8597,44017266,8067,1396,1374,22,17,135
406,ee13fd8e-9627-402e-9d3e-07d6f09c8597,44017266,8067,1422,1402,20,18,135
406,ee13fd8e-9627-402e-9d3e-07d6f09c8597,44017266,8067,1672,1436,236,23,135
406,ee13fd8e-9627-402e-9d3e-07d6f09c8597,44017266,8067,1682,1678,4,24,135
406,ee13fd8e-9627-402e-9d3e-07d6f09c8597,44017266,8067,1944,1686,258,30,135
406,ee13fd8e-9627-402e-9d3e-07d6f09c8597,44017266,8067,2209,1957,252,35,135
406,ee13fd8e-9627-402e-9d3e-07d6f09c8597,44017266,8067,2233,2217,16,36,135
406,ee13fd8e-9627-402e-9d3e-07d6f09c8597,44017266,8067,2269,2245,24,60,135
406,ee13fd8e-9627-402e-9d3e-07d6f09c8597,44017266,8067,2302,2277,25,61,135
406,ee13fd8e-9627-402e-9d3e-07d6f09c8597,44017266,8067,2391,2307,84,64,135
406,ee13fd8e-9627-402e-9d3e-07d6f09c8597,44017266,8067,2434,2400,34,65,135
406,ee13fd8e-9627-402e-9d3e-07d6f09c8597,44017266,8067,2522,2437,85,90,135
406,ee13fd8e-9627-402e-9d3e-07d6f09c8597,44017266,8067,2626,2545,81,91,135
406,ee13fd8e-9627-402e-9d3e-07d6f09c8597,44017266,8067,2933,2627,306,92,135
406,ee13fd8e-9627-402e-9d3e-07d6f09c8597,44017266,8067,3089,2935,154,93,135
406,ee13fd8e-9627-402e-9d3e-07d6f09c8597,44017266,8067,3928,3099,829,94,135
406,ee13fd8e-9627-402e-9d3e-07d6f09c8597,44017266,8067,4667,3932,735,95,135
406,ee13fd8e-9627-402e-9d3e-07d6f09c8597,44017266,8067,4635,4407,-228,96,135
406,ee13fd8e-9627-402e-9d3e-07d6f09c8597,44017266,8067,4403,4027,-376,97,135
406,ee13fd8e-9627-402e-9d3e-07d6f09c8597,44017266,8067,4049,4030,19,102,135
406,ee13fd8e-9627-402e-9d3e-07d6f09c8597,44017266,8067,4244,4053,191,103,135
406,ee13fd8e-9627-402e-9d3e-07d6f09c8597,44017266,8067,4559,4249,310,104,135
406,ee13fd8e-9627-402e-9d3e-07d6f09c8597,44017266,8067,4747,4563,184,105,135
406,ee13fd8e-9627-402e-9d3e-07d6f09c8597,44017266,8067,4796,4748,48,106,135
406,ee13fd8e-9627-402e-9d3e-07d6f09c8597,44017266,8067,4911,4797,114,107,135
406,ee13fd8e-9627-402e-9d3e-07d6f09c8597,44017266,8067,5008,4912,96,114,135
406,ee13fd8e-9627-402e-9d3e-07d6f09c8597,44017266,8067,5284,5009,275,115,135
406,ee13fd8e-9627-402e-9d3e-07d6f09c8597,44017266,8067,5560,5291,269,116,135
406,ee13fd8e-9627-402e-9d3e-07d6f09c8597,44017266,8067,6336,5570,766,117,135
406,ee13fd8e-9627-402e-9d3e-07d6f09c8597,44017266,8067,6387,6348,39,118,135
406,ee13fd8e-9627-402e-9d3e-07d6f09c8597,44017266,8067,6308,4329,-1979,119,135
406,ee13fd8e-9627-402e-9d3e-07d6f09c8597,44017266,8067,4302,2017,-2285,120,135
406,ee13fd8e-9627-402e-9d3e-07d6f09c8597,44017266,8067,1989,228,-1761,121,135
406,ee13fd8e-9627-402e-9d3e-07d6f09c8597,44017266,8067,211,0,-211,122,135
406,ee13fd8e-9627-402e-9d3e-07d6f09c8597,44017266,8067,832,57,775,126,135
406,ee13fd8e-9627-402e-9d3e-07d6f09c8597,44017266,8067,894,0,-894,127,135
406,ee13fd8e-9627-402e-9d3e-07d6f09c8597,44017266,8067,3549,79,3470,130,135
406,ee13fd8e-9627-402e-9d3e-07d6f09c8597,44017266,8067,4698,3641,1057,131,135
406,ee13fd8e-9627-402e-9d3e-07d6f09c8597,44017266,8067,6387,4708,1679,132,135
406,ee13fd8e-9627-402e-9d3e-07d6f09c8597,44017266,1680,0,0,0,135,135
406,ee13fd8e-9627-402e-9d3e-07d6f09c8597,44027773,3192,86,9,77,0,51
406,ee13fd8e-9627-402e-9d3e-07d6f09c8597,44027773,3192,367,88,279,1,51
406,ee13fd8e-9627-402e-9d3e-07d6f09c8597,44027773,3192,809,371,438,2,51
406,ee13fd8e-9627-402e-9d3e-07d6f09c8597,44027773,3192,942,813,129,3,51
406,ee13fd8e-9627-402e-9d3e-07d6f09c8597,44027773,3192,944,940,4,4,51
406,ee13fd8e-9627-402e-9d3e-07d6f09c8597,44027773,3192,947,944,3,5,51
406,ee13fd8e-9627-402e-9d3e-07d6f09c8597,44027773,3192,969,949,20,6,51
406,ee13fd8e-9627-402e-9d3e-07d6f09c8597,44027773,3192,1030,969,61,7,51
406,ee13fd8e-9627-402e-9d3e-07d6f09c8597,44027773,3192,1069,1032,37,8,51
406,ee13fd8e-9627-402e-9d3e-07d6f09c8597,44027773,3192,1093,1070,23,9,51
406,ee13fd8e-9627-402e-9d3e-07d6f09c8597,44027773,3192,1118,1095,23,10,51
406,ee13fd8e-9627-402e-9d3e-07d6f09c8597,44027773,3192,1159,1119,40,11,51
406,ee13fd8e-9627-402e-9d3e-07d6f09c8597,44027773,3192,1225,1160,65,12,51
406,ee13fd8e-9627-402e-9d3e-07d6f09c8597,44027773,3192,1300,1227,73,25,51
406,ee13fd8e-9627-402e-9d3e-07d6f09c8597,44027773,3192,1364,1303,61,26,51
406,ee13fd8e-9627-402e-9d3e-07d6f09c8597,44027773,3192,1406,1370,36,51,51
406,ee13fd8e-9627-402e-9d3e-07d6f09c8597,44006176,6588,378,11,367,0,101
406,ee13fd8e-9627-402e-9d3e-07d6f09c8597,44006176,6588,524,380,144,1,101
406,ee13fd8e-9627-402e-9d3e-07d6f09c8597,44006176,6588,606,526,80,2,101
406,ee13fd8e-9627-402e-9d3e-07d6f09c8597,44006176,6588,808,610,198,3,101
406,ee13fd8e-9627-402e-9d3e-07d6f09c8597,44006176,6588,941,819,122,4,101
406,ee13fd8e-9627-402e-9d3e-07d6f09c8597,44006176,6588,1433,960,473,15,101
406,ee13fd8e-9627-402e-9d3e-07d6f09c8597,44006176,6588,1434,1434,0,16,101
406,ee13fd8e-9627-402e-9d3e-07d6f09c8597,44006176,6588,1444,1438,6,24,101
406,ee13fd8e-9627-402e-9d3e-07d6f09c8597,44006176,6588,1528,1444,84,25,101
406,ee13fd8e-9627-402e-9d3e-07d6f09c8597,44006176,6588,1527,1527,0,26,101
406,ee13fd8e-9627-402e-9d3e-07d6f09c8597,44006176,6588,1566,1528,38,27,101
406,ee13fd8e-9627-402e-9d3e-07d6f09c8597,44006176,6588,1608,1563,45,28,101
406,ee13fd8e-9627-402e-9d3e-07d6f09c8597,44006176,6588,1632,1609,23,29,101
406,ee13fd8e-9627-402e-9d3e-07d6f09c8597,44006176,6588,1838,1640,198,32,101
406,ee13fd8e-9627-402e-9d3e-07d6f09c8597,44006176,6588,2103,1840,263,42,101
406,ee13fd8e-9627-402e-9d3e-07d6f09c8597,44006176,6588,2255,2107,148,51,101
406,ee13fd8e-9627-402e-9d3e-07d6f09c8597,44006176,6588,2321,2272,49,58,101
406,ee13fd8e-9627-402e-9d3e-07d6f09c8597,44006176,6588,2541,2328,213,59,101
406,ee13fd8e-9627-402e-9d3e-07d6f09c8597,44006176,6588,2561,2543,18,60,101
406,ee13fd8e-9627-402e-9d3e-07d6f09c8597,44006176,6588,2510,2345,-165,67,101
406,ee13fd8e-9627-402e-9d3e-07d6f09c8597,44006176,6588,2325,2016,-309,68,101
406,ee13fd8e-9627-402e-9d3e-07d6f09c8597,44006176,6588,2015,2015,0,70,101
406,ee13fd8e-9627-402e-9d3e-07d6f09c8597,44006176,6588,2199,2017,182,71,101
406,ee13fd8e-9627-402e-9d3e-07d6f09c8597,44006176,6588,2448,2202,246,72,101
406,ee13fd8e-9627-402e-9d3e-07d6f09c8597,44006176,6588,2624,2457,167,87,101
406,ee13fd8e-9627-402e-9d3e-07d6f09c8597,44006176,6588,2956,2634,322,88,101
406,ee13fd8e-9627-402e-9d3e-07d6f09c8597,44006176,6588,3218,2961,257,94,101
406,ee13fd8e-9627-402e-9d3e-07d6f09c8597,44006176,6588,3347,3222,125,95,101
406,ee13fd8e-9627-402e-9d3e-07d6f09c8597,44006176,6588,3361,3343,18,96,101
406,ee13fd8e-9627-402e-9d3e-07d6f09c8597,44006176,6588,3497,3362,135,97,101
406,ee13fd8e-9627-402e-9d3e-07d6f09c8597,44006176,6588,3671,3499,172,98,101
406,ee13fd8e-9627-402e-9d3e-07d6f09c8597,44006176,6588,3781,3674,107,99,101
406,ee13fd8e-9627-402e-9d3e-07d6f09c8597,44006176,6588,4523,3769,754,100,101
406,ee13fd8e-9627-402e-9d3e-07d6f09c8597,44006176,6588,4908,4527,381,101,101
406,ee13fd8e-9627-402e-9d3e-07d6f09c8597,43968765,8433,1196,29,1167,0,58
406,ee13fd8e-9627-402e-9d3e-07d6f09c8597,43968765,8433,2001,1259,742,1,58
406,ee13fd8e-9627-402e-9d3e-07d6f09c8597,43968765,8433,1797,508,-1289,2,58
406,ee13fd8e-9627-402e-9d3e-07d6f09c8597,43968765,8433,1009,833,176,3,58
406,ee13fd8e-9627-402e-9d3e-07d6f09c8597,43968765,8433,1512,1043,469,9,58
406,ee13fd8e-9627-402e-9d3e-07d6f09c8597,43968765,8433,1514,1513,1,10,58
406,ee13fd8e-9627-402e-9d3e-07d6f09c8597,43968765,8433,1646,1518,128,15,58
406,ee13fd8e-9627-402e-9d3e-07d6f09c8597,43968765,8433,1666,1650,16,17,58
406,ee13fd8e-9627-402e-9d3e-07d6f09c8597,43968765,8433,1753,1667,86,19,58
406,ee13fd8e-9627-402e-9d3e-07d6f09c8597,43968765,8433,1886,1756,130,20,58
406,ee13fd8e-9627-402e-9d3e-07d6f09c8597,43968765,8433,1912,1888,24,21,58
406,ee13fd8e-9627-402e-9d3e-07d6f09c8597,43968765,8433,1916,1913,3,22,58
406,ee13fd8e-9627-402e-9d3e-07d6f09c8597,43968765,8433,1915,1842,-73,23,58
406,ee13fd8e-9627-402e-9d3e-07d6f09c8597,43968765,8433,1844,1793,-51,24,58
406,ee13fd8e-9627-402e-9d3e-07d6f09c8597,43968765,8433,2215,1701,514,25,58
406,ee13fd8e-9627-402e-9d3e-07d6f09c8597,43968765,8433,2566,2225,341,26,58
406,ee13fd8e-9627-402e-9d3e-07d6f09c8597,43968765,8433,2568,2567,1,27,58
406,ee13fd8e-9627-402e-9d3e-07d6f09c8597,43968765,8433,2747,2571,176,31,58
406,ee13fd8e-9627-402e-9d3e-07d6f09c8597,43968765,8433,2923,2750,173,32,58
406,ee13fd8e-9627-402e-9d3e-07d6f09c8597,43968765,8433,3039,2943,96,33,58
406,ee13fd8e-9627-402e-9d3e-07d6f09c8597,43968765,8433,5004,3111,1893,34,58
406,ee13fd8e-9627-402e-9d3e-07d6f09c8597,43968765,8433,5959,5012,947,35,58
406,ee13fd8e-9627-402e-9d3e-07d6f09c8597,43968765,8433,6702,5972,730,36,58
406,ee13fd8e-9627-402e-9d3e-07d6f09c8597,43968765,8433,6753,6731,22,37,58
406,ee13fd8e-9627-402e-9d3e-07d6f09c8597,43968765,8433,6751,6654,-97,38,58
406,ee13fd8e-9627-402e-9d3e-07d6f09c8597,43968765,8433,6628,5504,-1124,39,58
406,ee13fd8e-9627-402e-9d3e-07d6f09c8597,43968765,8433,5487,5344,-143,40,58
406,ee13fd8e-9627-402e-9d3e-07d6f09c8597,43968765,8433,5465,5346,119,41,58
406,ee13fd8e-9627-402e-9d3e-07d6f09c8597,43968765,8433,5670,5468,202,42,58
406,ee13fd8e-9627-402e-9d3e-07d6f09c8597,43968765,8433,5714,5672,42,43,58
406,ee13fd8e-9627-402e-9d3e-07d6f09c8597,43968765,8433,6311,5749,562,57,58
406,ee13fd8e-9627-402e-9d3e-07d6f09c8597,43968765,8433,6753,6317,436,58,58
406,ee13fd8e-9627-402e-9d3e-07d6f09c8597,43981165,6195,1,1,0,0,90
406,ee13fd8e-9627-402e-9d3e-07d6f09c8597,43981165,6195,1393,13,1380,1,90
406,ee13fd8e-9627-402e-9d3e-07d6f09c8597,43981165,6195,3088,1433,1655,2,90
406,ee13fd8e-9627-402e-9d3e-07d6f09c8597,43981165,6195,4515,3116,1399,3,90
406,ee13fd8e-9627-402e-9d3e-07d6f09c8597,43981165,6195,4493,1486,-3007,4,90
406,ee13fd8e-9627-402e-9d3e-07d6f09c8597,43981165,6195,1459,764,-695,5,90
406,ee13fd8e-9627-402e-9d3e-07d6f09c8597,43981165,6195,766,765,1,8,90
406,ee13fd8e-9627-402e-9d3e-07d6f09c8597,43981165,6195,828,764,64,9,90
406,ee13fd8e-9627-402e-9d3e-07d6f09c8597,43981165,6195,877,820,57,10,90
406,ee13fd8e-9627-402e-9d3e-07d6f09c8597,43981165,6195,911,883,28,11,90
406,ee13fd8e-9627-402e-9d3e-07d6f09c8597,43981165,6195,1014,910,104,14,90
406,ee13fd8e-9627-402e-9d3e-07d6f09c8597,43981165,6195,1056,1017,39,15,90
406,ee13fd8e-9627-402e-9d3e-07d6f09c8597,43981165,6195,1202,1059,143,20,90
406,ee13fd8e-9627-402e-9d3e-07d6f09c8597,43981165,6195,1311,1209,102,21,90
406,ee13fd8e-9627-402e-9d3e-07d6f09c8597,43981165,6195,1359,1316,43,27,90
406,ee13fd8e-9627-402e-9d3e-07d6f09c8597,43981165,6195,1636,1368,268,28,90
406,ee13fd8e-9627-402e-9d3e-07d6f09c8597,43981165,6195,1845,1644,201,29,90
406,ee13fd8e-9627-402e-9d3e-07d6f09c8597,43981165,6195,1853,1848,5,30,90
406,ee13fd8e-9627-402e-9d3e-07d6f09c8597,43981165,6195,1859,1856,3,31,90
406,ee13fd8e-9627-402e-9d3e-07d6f09c8597,43981165,6195,1861,1860,1,34,90
406,ee13fd8e-9627-402e-9d3e-07d6f09c8597,43981165,6195,1997,1863,134,35,90
406,ee13fd8e-9627-402e-9d3e-07d6f09c8597,43981165,6195,2045,1998,47,36,90
406,ee13fd8e-9627-402e-9d3e-07d6f09c8597,43981165,6195,2224,2047,177,37,90
406,ee13fd8e-9627-402e-9d3e-07d6f09c8597,43981165,6195,2262,2226,36,38,90
406,ee13fd8e-9627-402e-9d3e-07d6f09c8597,43981165,6195,2314,2268,46,42,90
406,ee13fd8e-9627-402e-9d3e-07d6f09c8597,43981165,6195,2316,2315,1,43,90
406,ee13fd8e-9627-402e-9d3e-07d6f09c8597,43981165,6195,2398,2318,80,44,90
406,ee13fd8e-9627-402e-9d3e-07d6f09c8597,43981165,6195,2483,2399,84,45,90
406,ee13fd8e-9627-402e-9d3e-07d6f09c8597,43981165,6195,2579,2484,95,46,90
406,ee13fd8e-9627-402e-9d3e-07d6f09c8597,43981165,6195,2657,2581,76,47,90
406,ee13fd8e-9627-402e-9d3e-07d6f09c8597,43981165,6195,2714,2658,56,49,90
406,ee13fd8e-9627-402e-9d3e-07d6f09c8597,43981165,6195,2805,2713,92,50,90
406,ee13fd8e-9627-402e-9d3e-07d6f09c8597,43981165,6195,2908,2807,101,51,90
406,ee13fd8e-9627-402e-9d3e-07d6f09c8597,43981165,6195,3113,2916,197,52,90
406,ee13fd8e-9627-402e-9d3e-07d6f09c8597,43981165,6195,3114,3114,0,53,90
406,ee13fd8e-9627-402e-9d3e-07d6f09c8597,43981165,6195,3140,3113,27,55,90
406,ee13fd8e-9627-402e-9d3e-07d6f09c8597,43981165,6195,3142,3138,-4,56,90
406,ee13fd8e-9627-402e-9d3e-07d6f09c8597,43981165,6195,3137,3137,0,57,90
406,ee13fd8e-9627-402e-9d3e-07d6f09c8597,43981165,6195,3254,3136,118,58,90
406,ee13fd8e-9627-402e-9d3e-07d6f09c8597,43981165,6195,3434,3260,174,59,90
406,ee13fd8e-9627-402e-9d3e-07d6f09c8597,43981165,6195,3661,3442,219,60,90
406,ee13fd8e-9627-402e-9d3e-07d6f09c8597,43981165,6195,3688,3670,18,65,90
406,ee13fd8e-9627-402e-9d3e-07d6f09c8597,43981165,6195,4515,3692,823,66,90
406,ee13fd8e-9627-402e-9d3e-07d6f09c8597,43981165,6195,4515,4513,-2,84,90
406,ee13fd8e-9627-402e-9d3e-07d6f09c8597,43981165,6195,4515,4511,-4,85,90
406,ee13fd8e-9627-402e-9d3e-07d6f09c8597,43981165,6195,4515,4501,-14,89,90
406,ee13fd8e-9627-402e-9d3e-07d6f09c8597,43981165,6195,4500,4493,-7,90,90
409,4361e0e2-052a-495f-86a2-c93e7eccc23c,44005013,11756,154,6,148,0,94
409,4361e0e2-052a-495f-86a2-c93e7eccc23c,44005013,11756,260,0,260,1,94
409,4361e0e2-052a-495f-86a2-c93e7eccc23c,44005013,11756,793,273,520,2,94
409,4361e0e2-052a-495f-86a2-c93e7eccc23c,44005013,11756,1286,844,442,3,94
409,4361e0e2-052a-495f-86a2-c93e7eccc23c,44005013,11756,1468,1288,180,4,94
409,4361e0e2-052a-495f-86a2-c93e7eccc23c,44005013,11756,1623,1480,143,5,94
409,4361e0e2-052a-495f-86a2-c93e7eccc23c,44005013,11756,1698,1626,72,8,94
409,4361e0e2-052a-495f-86a2-c93e7eccc23c,44005013,11756,1750,1701,49,9,94
409,4361e0e2-052a-495f-86a2-c93e7eccc23c,44005013,11756,1819,1758,61,10,94
409,4361e0e2-052a-495f-86a2-c93e7eccc23c,44005013,11756,1921,1820,101,11,94
409,4361e0e2-052a-495f-86a2-c93e7eccc23c,44005013,11756,2068,1923,145,23,94
409,4361e0e2-052a-495f-86a2-c93e7eccc23c,44005013,11756,2189,2068,121,30,94
409,4361e0e2-052a-495f-86a2-c93e7eccc23c,44005013,11756,2236,2198,38,31,94
409,4361e0e2-052a-495f-86a2-c93e7eccc23c,44005013,11756,2386,2245,141,33,94
409,4361e0e2-052a-495f-86a2-c93e7eccc23c,44005013,11756,2576,2387,189,38,94
409,4361e0e2-052a-495f-86a2-c93e7eccc23c,44005013,11756,2682,2568,114,39,94
409,4361e0e2-052a-495f-86a2-c93e7eccc23c,44005013,11756,2793,2684,109,41,94
409,4361e0e2-052a-495f-86a2-c93e7eccc23c,44005013,11756,2926,2795,131,45,94
409,4361e0e2-052a-495f-86a2-c93e7eccc23c,44005013,11756,3067,2930,137,47,94
409,4361e0e2-052a-495f-86a2-c93e7eccc23c,44005013,11756,3190,3077,113,48,94
409,4361e0e2-052a-495f-86a2-c93e7eccc23c,44005013,11756,3200,3193,7,49,94
409,4361e0e2-052a-495f-86a2-c93e7eccc23c,44005013,11756,3330,3208,122,55,94
409,4361e0e2-052a-495f-86a2-c93e7eccc23c,44005013,11756,3426,3331,95,56,94
409,4361e0e2-052a-495f-86a2-c93e7eccc23c,44005013,11756,3537,3431,106,57,94
409,4361e0e2-052a-495f-86a2-c93e7eccc23c,44005013,11756,3802,3546,256,58,94
409,4361e0e2-052a-495f-86a2-c93e7eccc23c,44005013,11756,4220,3808,412,59,94
409,4361e0e2-052a-495f-86a2-c93e7eccc23c,44005013,11756,4307,4231,76,60,94
409,4361e0e2-052a-495f-86a2-c93e7eccc23c,44005013,11756,4757,4316,441,92,94
409,4361e0e2-052a-495f-86a2-c93e7eccc23c,44005013,11756,5178,4760,418,93,94
409,4361e0e2-052a-495f-86a2-c93e7eccc23c,44005013,11756,5328,5187,141,94,94
409,ae46fb17-524b-45a8-bf18-4f001d47cdba,44027773,7628,149,12,137,0,39
409,ae46fb17-524b-45a8-bf18-4f001d47cdba,44027773,7628,160,153,7,1,39
409,ae46fb17-524b-45a8-bf18-4f001d47cdba,44027773,7628,317,172,145,2,39
409,ae46fb17-524b-45a8-bf18-4f001d47cdba,44027773,7628,312,0,-312,6,39
409,ae46fb17-524b-45a8-bf18-4f001d47cdba,44027773,7628,219,2,217,15,39
409,ae46fb17-524b-45a8-bf18-4f001d47cdba,44027773,7628,464,225,239,16,39
409,ae46fb17-524b-45a8-bf18-4f001d47cdba,44027773,7628,504,474,30,17,39
409,ae46fb17-524b-45a8-bf18-4f001d47cdba,44027773,7628,497,45,-452,19,39
409,ae46fb17-524b-45a8-bf18-4f001d47cdba,44027773,7628,39,20,-19,20,39
409,ae46fb17-524b-45a8-bf18-4f001d47cdba,44027773,7628,71,25,46,21,39
409,ae46fb17-524b-45a8-bf18-4f001d47cdba,44027773,7628,732,122,610,22,39
409,ae46fb17-524b-45a8-bf18-4f001d47cdba,44027773,7628,950,735,215,23,39
409,ae46fb17-524b-45a8-bf18-4f001d47cdba,44027773,7628,1135,960,175,25,39
409,ae46fb17-524b-45a8-bf18-4f001d47cdba,44027773,7628,1302,1138,164,26,39
409,ae46fb17-524b-45a8-bf18-4f001d47cdba,44027773,7628,1524,1304,220,33,39
409,ae46fb17-524b-45a8-bf18-4f001d47cdba,44027773,7628,1780,1531,249,34,39
409,ae46fb17-524b-45a8-bf18-4f001d47cdba,44027773,7628,1881,1779,102,35,39
409,ae46fb17-524b-45a8-bf18-4f001d47cdba,44027773,7628,1978,1895,83,36,39
409,ae46fb17-524b-45a8-bf18-4f001d47cdba,44027773,7628,2218,1979,239,37,39
409,ae46fb17-524b-45a8-bf18-4f001d47cdba,44027773,7628,2744,2235,509,38,39
409,ae46fb17-524b-45a8-bf18-4f001d47cdba,44027773,7628,2762,2754,8,39,39
407,f8700433-35d8-4aa0-b1f2-63d8b88715a0,44032295,3888,157,2,155,0,15
407,f8700433-35d8-4aa0-b1f2-63d8b88715a0,44032295,3888,388,162,226,1,15
407,f8700433-35d8-4aa0-b1f2-63d8b88715a0,44032295,3888,503,396,107,2,15
407,f8700433-35d8-4aa0-b1f2-63d8b88715a0,44032295,3888,772,506,266,4,15
407,f8700433-35d8-4aa0-b1f2-63d8b88715a0,44032295,3888,1027,773,254,5,15
407,f8700433-35d8-4aa0-b1f2-63d8b88715a0,44032295,3888,1135,1033,102,6,15
407,f8700433-35d8-4aa0-b1f2-63d8b88715a0,44032295,3888,1242,1147,95,7,15
407,f8700433-35d8-4aa0-b1f2-63d8b88715a0,44032295,3888,1601,1252,349,8,15
407,f8700433-35d8-4aa0-b1f2-63d8b88715a0,44032295,3888,1921,1622,299,13,15
407,f8700433-35d8-4aa0-b1f2-63d8b88715a0,44032295,3888,2508,1953,555,14,15
407,f8700433-35d8-4aa0-b1f2-63d8b88715a0,44032295,3888,2483,0,-2483,15,15
407,f8700433-35d8-4aa0-b1f2-63d8b88715a0,44028366,5292,7,7,0,0,11
407,f8700433-35d8-4aa0-b1f2-63d8b88715a0,44028366,5292,45,15,30,1,11
407,f8700433-35d8-4aa0-b1f2-63d8b88715a0,44028366,5292,547,50,497,2,11
407,f8700433-35d8-4aa0-b1f2-63d8b88715a0,44028366,5292,608,565,43,4,11
407,f8700433-35d8-4aa0-b1f2-63d8b88715a0,44028366,5292,641,617,24,5,11
407,f8700433-35d8-4aa0-b1f2-63d8b88715a0,44028366,5292,726,646,80,7,11
407,f8700433-35d8-4aa0-b1f2-63d8b88715a0,44028366,5292,783,738,45,8,11
407,f8700433-35d8-4aa0-b1f2-63d8b88715a0,44028366,5292,1288,810,478,9,11
407,f8700433-35d8-4aa0-b1f2-63d8b88715a0,44028366,5292,2368,1339,1029,10,11
407,f8700433-35d8-4aa0-b1f2-63d8b88715a0,44028366,5292,2448,2378,70,11,11
407,f8700433-35d8-4aa0-b1f2-63d8b88715a0,44003853,5487,325,11,314,0,79
407,f8700433-35d8-4aa0-b1f2-63d8b88715a0,44003853,5487,515,330,185,1,79
407,f8700433-35d8-4aa0-b1f2-63d8b88715a0,44003853,5487,642,519,123,2,79
407,f8700433-35d8-4aa0-b1f2-63d8b88715a0,44003853,5487,790,653,137,3,79
407,f8700433-35d8-4aa0-b1f2-63d8b88715a0,44003853,5487,883,805,78,4,79
407,f8700433-35d8-4aa0-b1f2-63d8b88715a0,44003853,5487,959,896,63,6,79
407,f8700433-35d8-4aa0-b1f2-63d8b88715a0,44003853,5487,1362,979,383,12,79
407,f8700433-35d8-4aa0-b1f2-63d8b88715a0,44003853,5487,1539,1376,163,13,79
407,f8700433-35d8-4aa0-b1f2-63d8b88715a0,44003853,5487,2297,1568,729,14,79
407,f8700433-35d8-4aa0-b1f2-63d8b88715a0,44003853,5487,2518,2311,207,16,79
407,f8700433-35d8-4aa0-b1f2-63d8b88715a0,44003853,5487,2668,2520,148,17,79
407,f8700433-35d8-4aa0-b1f2-63d8b88715a0,44003853,5487,2794,2674,120,18,79
407,f8700433-35d8-4aa0-b1f2-63d8b88715a0,44003853,5487,3155,2814,341,19,79
407,f8700433-35d8-4aa0-b1f2-63d8b88715a0,44003853,5487,3247,3161,86,20,79
407,f8700433-35d8-4aa0-b1f2-63d8b88715a0,44003853,5487,4106,3261,845,78,79
407,f8700433-35d8-4aa0-b1f2-63d8b88715a0,44003853,5487,4107,4107,0,79,79
407,f8700433-35d8-4aa0-b1f2-63d8b88715a0,44026548,9627,32,1,31,0,13
407,f8700433-35d8-4aa0-b1f2-63d8b88715a0,44026548,9627,34,33,1,1,13
407,f8700433-35d8-4aa0-b1f2-63d8b88715a0,44026548,9627,357,50,307,3,13
407,f8700433-35d8-4aa0-b1f2-63d8b88715a0,44026548,9627,425,371,54,4,13
407,f8700433-35d8-4aa0-b1f2-63d8b88715a0,44026548,9627,574,450,124,6,13
407,f8700433-35d8-4aa0-b1f2-63d8b88715a0,44026548,9627,953,576,377,7,13
407,f8700433-35d8-4aa0-b1f2-63d8b88715a0,44026548,9627,1102,955,147,8,13
407,f8700433-35d8-4aa0-b1f2-63d8b88715a0,44026548,9627,1169,1106,63,9,13
407,f8700433-35d8-4aa0-b1f2-63d8b88715a0,44026548,9627,1274,1179,95,10,13
407,f8700433-35d8-4aa0-b1f2-63d8b88715a0,44026548,9627,1315,1275,40,11,13
407,f8700433-35d8-4aa0-b1f2-63d8b88715a0,44026548,9627,1317,1317,0,12,13
407,f8700433-35d8-4aa0-b1f2-63d8b88715a0,44026548,9627,1477,1333,144,13,13
407,f8700433-35d8-4aa0-b1f2-63d8b88715a0,44005013,8817,205,14,191,0,31
407,f8700433-35d8-4aa0-b1f2-63d8b88715a0,44005013,8817,209,206,3,1,31
407,f8700433-35d8-4aa0-b1f2-63d8b88715a0,44005013,8817,538,227,311,2,31
407,f8700433-35d8-4aa0-b1f2-63d8b88715a0,44005013,8817,761,547,214,3,31
407,f8700433-35d8-4aa0-b1f2-63d8b88715a0,44005013,8817,947,763,184,4,31
407,f8700433-35d8-4aa0-b1f2-63d8b88715a0,44005013,8817,963,948,15,5,31
407,f8700433-35d8-4aa0-b1f2-63d8b88715a0,44005013,8817,1153,967,186,6,31
407,f8700433-35d8-4aa0-b1f2-63d8b88715a0,44005013,8817,1371,1157,214,7,31
407,f8700433-35d8-4aa0-b1f2-63d8b88715a0,44005013,8817,1468,1373,95,8,31
407,f8700433-35d8-4aa0-b1f2-63d8b88715a0,44005013,8817,1513,1470,43,9,31
407,f8700433-35d8-4aa0-b1f2-63d8b88715a0,44005013,8817,1558,1516,42,10,31
407,f8700433-35d8-4aa0-b1f2-63d8b88715a0,44005013,8817,1612,1561,51,11,31
407,f8700433-35d8-4aa0-b1f2-63d8b88715a0,44005013,8817,1684,1624,60,12,31
407,f8700433-35d8-4aa0-b1f2-63d8b88715a0,44005013,8817,1719,1690,29,13,31
407,f8700433-35d8-4aa0-b1f2-63d8b88715a0,44005013,8817,1760,1727,33,14,31
407,f8700433-35d8-4aa0-b1f2-63d8b88715a0,44005013,8817,1826,1775,51,15,31
407,f8700433-35d8-4aa0-b1f2-63d8b88715a0,44005013,8817,1978,1829,149,16,31
407,f8700433-35d8-4aa0-b1f2-63d8b88715a0,44005013,8817,2040,1981,59,17,31
407,f8700433-35d8-4aa0-b1f2-63d8b88715a0,44005013,8817,2092,2051,41,18,31
407,f8700433-35d8-4aa0-b1f2-63d8b88715a0,44005013,8817,2206,2100,106,20,31
407,f8700433-35d8-4aa0-b1f2-63d8b88715a0,44005013,8817,2503,2215,288,21,31
407,f8700433-35d8-4aa0-b1f2-63d8b88715a0,44005013,8817,2800,2507,293,22,31
407,f8700433-35d8-4aa0-b1f2-63d8b88715a0,44005013,8817,2847,2803,44,24,31
407,f8700433-35d8-4aa0-b1f2-63d8b88715a0,44005013,8817,2971,2851,120,25,31
407,f8700433-35d8-4aa0-b1f2-63d8b88715a0,44005013,8817,3168,2981,187,26,31
407,f8700433-35d8-4aa0-b1f2-63d8b88715a0,44005013,8817,3586,3184,402,27,31
407,f8700433-35d8-4aa0-b1f2-63d8b88715a0,44005013,8817,6199,3650,2549,28,31
407,f8700433-35d8-4aa0-b1f2-63d8b88715a0,44005013,8817,7437,6201,1236,29,31
407,f8700433-35d8-4aa0-b1f2-63d8b88715a0,44005013,8817,7427,7158,-269,30,31
407,f8700433-35d8-4aa0-b1f2-63d8b88715a0,44005013,8817,7144,7074,-70,31,31
407,f8700433-35d8-4aa0-b1f2-63d8b88715a0,44029224,4608,141,16,125,0,18
407,f8700433-35d8-4aa0-b1f2-63d8b88715a0,44029224,4608,255,144,111,1,18
407,f8700433-35d8-4aa0-b1f2-63d8b88715a0,44029224,4608,316,267,49,2,18
407,f8700433-35d8-4aa0-b1f2-63d8b88715a0,44029224,4608,433,328,105,3,18
407,f8700433-35d8-4aa0-b1f2-63d8b88715a0,44029224,4608,699,451,248,4,18
407,f8700433-35d8-4aa0-b1f2-63d8b88715a0,44029224,4608,1205,711,494,5,18
407,f8700433-35d8-4aa0-b1f2-63d8b88715a0,44029224,4608,1209,1207,2,6,18
407,f8700433-35d8-4aa0-b1f2-63d8b88715a0,44029224,4608,1639,1246,393,18,18
407,557462e7-be73-426c-8284-a2ef9fc0001f,44034532,2940,561,15,546,0,13
407,557462e7-be73-426c-8284-a2ef9fc0001f,44034532,2940,784,565,219,1,13
407,557462e7-be73-426c-8284-a2ef9fc0001f,44034532,2940,898,789,109,2,13
407,557462e7-be73-426c-8284-a2ef9fc0001f,44034532,2940,959,903,56,3,13
407,557462e7-be73-426c-8284-a2ef9fc0001f,44034532,2940,1012,967,45,6,13
407,557462e7-be73-426c-8284-a2ef9fc0001f,44034532,2940,1115,1016,99,7,13
407,557462e7-be73-426c-8284-a2ef9fc0001f,44034532,2940,1197,1120,77,9,13
407,557462e7-be73-426c-8284-a2ef9fc0001f,44034532,2940,1246,1204,42,10,13
407,557462e7-be73-426c-8284-a2ef9fc0001f,44034532,2940,1344,1254,90,11,13
407,557462e7-be73-426c-8284-a2ef9fc0001f,44034532,2940,1398,1348,50,12,13
407,557462e7-be73-426c-8284-a2ef9fc0001f,44034532,2940,1560,1410,150,13,13
409,8f7f1eba-f95d-40ed-8d13-5ef110e46727,44047113,6892,386,1,385,0,44
409,8f7f1eba-f95d-40ed-8d13-5ef110e46727,44047113,6892,560,394,166,1,44
409,8f7f1eba-f95d-40ed-8d13-5ef110e46727,44047113,6892,706,573,133,2,44
409,8f7f1eba-f95d-40ed-8d13-5ef110e46727,44047113,6892,978,709,269,3,44
409,8f7f1eba-f95d-40ed-8d13-5ef110e46727,44047113,6892,1085,987,98,4,44
409,8f7f1eba-f95d-40ed-8d13-5ef110e46727,44047113,6892,1255,1095,160,5,44
409,8f7f1eba-f95d-40ed-8d13-5ef110e46727,44047113,6892,1410,1258,152,6,44
409,8f7f1eba-f95d-40ed-8d13-5ef110e46727,44047113,6892,1478,1414,64,7,44
409,8f7f1eba-f95d-40ed-8d13-5ef110e46727,44047113,6892,1533,1487,46,8,44
409,8f7f1eba-f95d-40ed-8d13-5ef110e46727,44047113,6892,1699,1543,156,9,44
409,8f7f1eba-f95d-40ed-8d13-5ef110e46727,44047113,6892,1814,1702,112,10,44
409,8f7f1eba-f95d-40ed-8d13-5ef110e46727,44047113,6892,1817,1815,2,11,44
409,8f7f1eba-f95d-40ed-8d13-5ef110e46727,44047113,6892,1878,1823,55,12,44
409,8f7f1eba-f95d-40ed-8d13-5ef110e46727,44047113,6892,1964,1885,79,16,44
409,8f7f1eba-f95d-40ed-8d13-5ef110e46727,44047113,6892,2047,1966,81,17,44
409,8f7f1eba-f95d-40ed-8d13-5ef110e46727,44047113,6892,2118,2045,73,18,44
409,8f7f1eba-f95d-40ed-8d13-5ef110e46727,44047113,6892,2097,1753,-344,19,44
409,8f7f1eba-f95d-40ed-8d13-5ef110e46727,44047113,6892,1786,1765,21,22,44
409,8f7f1eba-f95d-40ed-8d13-5ef110e46727,44047113,6892,1969,1798,171,23,44
409,8f7f1eba-f95d-40ed-8d13-5ef110e46727,44047113,6892,2061,1970,91,24,44
409,8f7f1eba-f95d-40ed-8d13-5ef110e46727,44047113,6892,2248,2069,179,25,44
409,8f7f1eba-f95d-40ed-8d13-5ef110e46727,44047113,6892,2356,2252,104,26,44
409,8f7f1eba-f95d-40ed-8d13-5ef110e46727,44047113,6892,2450,2360,90,27,44
409,8f7f1eba-f95d-40ed-8d13-5ef110e46727,44047113,6892,2465,2454,11,28,44
409,8f7f1eba-f95d-40ed-8d13-5ef110e46727,44047113,6892,2513,2466,47,30,44
409,8f7f1eba-f95d-40ed-8d13-5ef110e46727,44047113,6892,2562,2518,44,31,44
409,8f7f1eba-f95d-40ed-8d13-5ef110e46727,44047113,6892,4860,2612,2248,32,44
409,8f7f1eba-f95d-40ed-8d13-5ef110e46727,44047113,6892,4858,4858,0,41,44
409,8f7f1eba-f95d-40ed-8d13-5ef110e46727,44047113,6892,4860,4860,0,42,44
409,8f7f1eba-f95d-40ed-8d13-5ef110e46727,44047113,6892,4847,4598,-249,43,44
409,8f7f1eba-f95d-40ed-8d13-5ef110e46727,44047113,6892,4860,4601,259,44,44
409,8f7f1eba-f95d-40ed-8d13-5ef110e46727,44039616,4836,352,1,351,0,56
409,8f7f1eba-f95d-40ed-8d13-5ef110e46727,44039616,4836,516,350,166,1,56
409,8f7f1eba-f95d-40ed-8d13-5ef110e46727,44039616,4836,609,517,92,2,56
409,8f7f1eba-f95d-40ed-8d13-5ef110e46727,44039616,4836,692,611,81,3,56
409,8f7f1eba-f95d-40ed-8d13-5ef110e46727,44039616,4836,651,0,-651,4,56
409,8f7f1eba-f95d-40ed-8d13-5ef110e46727,44039616,4836,640,10,630,26,56
409,8f7f1eba-f95d-40ed-8d13-5ef110e46727,44039616,4836,991,662,329,27,56
409,8f7f1eba-f95d-40ed-8d13-5ef110e46727,44039616,4836,1299,971,328,28,56
409,8f7f1eba-f95d-40ed-8d13-5ef110e46727,44039616,4836,1473,1315,158,29,56
409,8f7f1eba-f95d-40ed-8d13-5ef110e46727,44039616,4836,1573,1476,97,30,56
409,8f7f1eba-f95d-40ed-8d13-5ef110e46727,44039616,4836,1542,0,-1542,32,56
409,8f7f1eba-f95d-40ed-8d13-5ef110e46727,44039616,4836,76,13,63,34,56
409,8f7f1eba-f95d-40ed-8d13-5ef110e46727,44039616,4836,62,0,-62,35,56
409,8f7f1eba-f95d-40ed-8d13-5ef110e46727,44039616,4836,377,28,349,36,56
409,8f7f1eba-f95d-40ed-8d13-5ef110e46727,44039616,4836,860,378,482,37,56
409,8f7f1eba-f95d-40ed-8d13-5ef110e46727,44039616,4836,1007,861,146,38,56
409,8f7f1eba-f95d-40ed-8d13-5ef110e46727,44039616,4836,1310,1010,300,39,56
409,8f7f1eba-f95d-40ed-8d13-5ef110e46727,44039616,4836,1465,1311,154,40,56
409,8f7f1eba-f95d-40ed-8d13-5ef110e46727,44039616,4836,1596,1479,117,41,56
409,8f7f1eba-f95d-40ed-8d13-5ef110e46727,44039616,4836,1704,1598,106,42,56
409,8f7f1eba-f95d-40ed-8d13-5ef110e46727,44039616,4836,1846,1706,140,44,56
409,8f7f1eba-f95d-40ed-8d13-5ef110e46727,44039616,4836,1926,1853,73,45,56
409,8f7f1eba-f95d-40ed-8d13-5ef110e46727,44039616,4836,2076,1927,149,46,56
409,8f7f1eba-f95d-40ed-8d13-5ef110e46727,44039616,4836,2188,2077,111,47,56
409,8f7f1eba-f95d-40ed-8d13-5ef110e46727,44039616,4836,2303,2189,114,48,56
409,8f7f1eba-f95d-40ed-8d13-5ef110e46727,44039616,4836,2413,2307,106,50,56
409,8f7f1eba-f95d-40ed-8d13-5ef110e46727,44039616,4836,2403,2284,-119,51,56
409,8f7f1eba-f95d-40ed-8d13-5ef110e46727,44039616,4836,2410,2298,112,53,56
409,8f7f1eba-f95d-40ed-8d13-5ef110e46727,44039616,4836,2535,2414,121,54,56
409,8f7f1eba-f95d-40ed-8d13-5ef110e46727,44039616,4836,2780,2537,243,55,56
409,8f7f1eba-f95d-40ed-8d13-5ef110e46727,44039616,4836,2804,2787,17,56,56
409,8f7f1eba-f95d-40ed-8d13-5ef110e46727,44038086,21348,213,4,209,0,46
409,8f7f1eba-f95d-40ed-8d13-5ef110e46727,44038086,21348,579,233,346,1,46
409,8f7f1eba-f95d-40ed-8d13-5ef110e46727,44038086,21348,874,586,288,2,46
409,8f7f1eba-f95d-40ed-8d13-5ef110e46727,44038086,21348,1124,875,249,3,46
409,8f7f1eba-f95d-40ed-8d13-5ef110e46727,44038086,21348,1534,1128,406,4,46
409,8f7f1eba-f95d-40ed-8d13-5ef110e46727,44038086,21348,1852,1543,309,5,46
409,8f7f1eba-f95d-40ed-8d13-5ef110e46727,44038086,21348,2496,1869,627,6,46
409,8f7f1eba-f95d-40ed-8d13-5ef110e46727,44038086,21348,2969,2515,454,7,46
409,8f7f1eba-f95d-40ed-8d13-5ef110e46727,44038086,21348,3172,2977,195,8,46
409,8f7f1eba-f95d-40ed-8d13-5ef110e46727,44038086,21348,3373,3176,197,10,46
409,8f7f1eba-f95d-40ed-8d13-5ef110e46727,44038086,21348,3495,3390,105,11,46
409,8f7f1eba-f95d-40ed-8d13-5ef110e46727,44038086,21348,3598,3499,99,12,46
409,8f7f1eba-f95d-40ed-8d13-5ef110e46727,44038086,21348,3710,3607,103,14,46
409,8f7f1eba-f95d-40ed-8d13-5ef110e46727,44038086,21348,5142,3722,1420,15,46
409,8f7f1eba-f95d-40ed-8d13-5ef110e46727,44038086,21348,5636,5179,457,16,46
409,8f7f1eba-f95d-40ed-8d13-5ef110e46727,44038086,21348,6040,5631,409,17,46
409,8f7f1eba-f95d-40ed-8d13-5ef110e46727,44038086,21348,6281,6046,235,18,46
409,8f7f1eba-f95d-40ed-8d13-5ef110e46727,44038086,21348,7594,6346,1248,19,46
409,8f7f1eba-f95d-40ed-8d13-5ef110e46727,44038086,21348,7916,7602,314,20,46
409,8f7f1eba-f95d-40ed-8d13-5ef110e46727,44038086,21348,8419,7931,488,21,46
409,8f7f1eba-f95d-40ed-8d13-5ef110e46727,44038086,21348,8574,8419,155,22,46
409,8f7f1eba-f95d-40ed-8d13-5ef110e46727,44038086,21348,8786,8583,203,23,46
409,8f7f1eba-f95d-40ed-8d13-5ef110e46727,44038086,21348,9057,8776,281,24,46
409,8f7f1eba-f95d-40ed-8d13-5ef110e46727,44038086,21348,9067,9058,9,25,46
409,8f7f1eba-f95d-40ed-8d13-5ef110e46727,44038086,21348,9158,9067,91,26,46
409,8f7f1eba-f95d-40ed-8d13-5ef110e46727,44038086,21348,9198,9162,36,27,46
409,8f7f1eba-f95d-40ed-8d13-5ef110e46727,44038086,21348,11280,9203,2077,28,46
409,8f7f1eba-f95d-40ed-8d13-5ef110e46727,44038086,21348,11445,11294,151,29,46
409,8f7f1eba-f95d-40ed-8d13-5ef110e46727,44038086,21348,11593,11447,146,30,46
409,8f7f1eba-f95d-40ed-8d13-5ef110e46727,44038086,21348,11684,11601,83,31,46
409,8f7f1eba-f95d-40ed-8d13-5ef110e46727,44038086,21348,14275,11705,2570,32,46
409,8f7f1eba-f95d-40ed-8d13-5ef110e46727,44038086,21348,14317,14279,38,33,46
409,8f7f1eba-f95d-40ed-8d13-5ef110e46727,44038086,21348,14421,14317,104,34,46
409,8f7f1eba-f95d-40ed-8d13-5ef110e46727,44038086,21348,15490,14422,1068,35,46
409,8f7f1eba-f95d-40ed-8d13-5ef110e46727,44038086,21348,15487,14676,-811,36,46
409,8f7f1eba-f95d-40ed-8d13-5ef110e46727,44038086,21348,16954,14673,2281,37,46
409,8f7f1eba-f95d-40ed-8d13-5ef110e46727,44038086,21348,17182,16968,214,38,46
409,8f7f1eba-f95d-40ed-8d13-5ef110e46727,44038086,21348,17227,17175,52,39,46
409,8f7f1eba-f95d-40ed-8d13-5ef110e46727,44038086,21348,17268,17231,37,40,46
409,8f7f1eba-f95d-40ed-8d13-5ef110e46727,44038086,21348,17353,17271,82,41,46
409,8f7f1eba-f95d-40ed-8d13-5ef110e46727,44038086,21348,17349,17263,-86,42,46
409,8f7f1eba-f95d-40ed-8d13-5ef110e46727,44038086,21348,17478,17297,181,45,46
409,8f7f1eba-f95d-40ed-8d13-5ef110e46727,44038086,21348,19316,17484,1832,46,46
407,6b114d4e-8d1c-4231-b6b7-375c35069c86,44049532,10509,100,6,94,0,15
407,6b114d4e-8d1c-4231-b6b7-375c35069c86,44049532,10509,241,103,138,1,15
407,6b114d4e-8d1c-4231-b6b7-375c35069c86,44049532,10509,309,247,62,2,15
407,6b114d4e-8d1c-4231-b6b7-375c35069c86,44049532,10509,483,258,-225,3,15
407,6b114d4e-8d1c-4231-b6b7-375c35069c86,44049532,10509,266,0,266,4,15
407,6b114d4e-8d1c-4231-b6b7-375c35069c86,44049532,10509,399,277,122,5,15
407,6b114d4e-8d1c-4231-b6b7-375c35069c86,44049532,10509,598,401,197,6,15
407,6b114d4e-8d1c-4231-b6b7-375c35069c86,44049532,10509,922,614,308,7,15
407,6b114d4e-8d1c-4231-b6b7-375c35069c86,44049532,10509,1536,930,606,8,15
407,6b114d4e-8d1c-4231-b6b7-375c35069c86,44049532,10509,1658,1548,110,9,15
407,6b114d4e-8d1c-4231-b6b7-375c35069c86,44049532,10509,1760,1664,96,10,15
407,6b114d4e-8d1c-4231-b6b7-375c35069c86,44049532,10509,1986,1767,219,12,15
407,6b114d4e-8d1c-4231-b6b7-375c35069c86,44049532,10509,3421,2021,1400,13,15
407,6b114d4e-8d1c-4231-b6b7-375c35069c86,44049532,10509,3846,3479,367,14,15
407,6b114d4e-8d1c-4231-b6b7-375c35069c86,44049532,10509,3634,3574,-60,15,15
407,6b114d4e-8d1c-4231-b6b7-375c35069c86,44039666,13230,201,7,194,0,87
407,6b114d4e-8d1c-4231-b6b7-375c35069c86,44039666,13230,350,204,146,2,87
407,6b114d4e-8d1c-4231-b6b7-375c35069c86,44039666,13230,404,356,48,9,87
407,6b114d4e-8d1c-4231-b6b7-375c35069c86,44039666,13230,478,407,71,10,87
407,6b114d4e-8d1c-4231-b6b7-375c35069c86,44039666,13230,570,486,84,11,87
407,6b114d4e-8d1c-4231-b6b7-375c35069c86,44039666,13230,739,571,168,12,87
407,6b114d4e-8d1c-4231-b6b7-375c35069c86,44039666,13230,1022,740,282,13,87
407,6b114d4e-8d1c-4231-b6b7-375c35069c86,44039666,13230,1131,1026,105,17,87
407,6b114d4e-8d1c-4231-b6b7-375c35069c86,44039666,13230,1342,1134,208,21,87
407,6b114d4e-8d1c-4231-b6b7-375c35069c86,44039666,13230,1410,1348,62,23,87
407,6b114d4e-8d1c-4231-b6b7-375c35069c86,44039666,13230,1560,1414,146,24,87
407,6b114d4e-8d1c-4231-b6b7-375c35069c86,44039666,13230,1739,1569,170,25,87
407,6b114d4e-8d1c-4231-b6b7-375c35069c86,44039666,13230,2095,1750,345,26,87
407,6b114d4e-8d1c-4231-b6b7-375c35069c86,44039666,13230,2330,2102,228,27,87
407,6b114d4e-8d1c-4231-b6b7-375c35069c86,44039666,13230,2331,2331,0,28,87
407,6b114d4e-8d1c-4231-b6b7-375c35069c86,44039666,13230,2426,2342,84,36,87
407,6b114d4e-8d1c-4231-b6b7-375c35069c86,44039666,13230,2667,2431,236,37,87
407,6b114d4e-8d1c-4231-b6b7-375c35069c86,44039666,13230,2685,2673,12,38,87
407,6b114d4e-8d1c-4231-b6b7-375c35069c86,44039666,13230,2710,2690,20,39,87
407,6b114d4e-8d1c-4231-b6b7-375c35069c86,44039666,13230,2797,2713,84,40,87
407,6b114d4e-8d1c-4231-b6b7-375c35069c86,44039666,13230,2854,2799,55,42,87
407,6b114d4e-8d1c-4231-b6b7-375c35069c86,44039666,13230,2881,2857,24,43,87
407,6b114d4e-8d1c-4231-b6b7-375c35069c86,44039666,13230,3019,2886,133,46,87
407,6b114d4e-8d1c-4231-b6b7-375c35069c86,44039666,13230,3063,3030,33,47,87
407,6b114d4e-8d1c-4231-b6b7-375c35069c86,44039666,13230,3286,3065,221,50,87
407,6b114d4e-8d1c-4231-b6b7-375c35069c86,44039666,13230,3389,3291,98,53,87
407,6b114d4e-8d1c-4231-b6b7-375c35069c86,44039666,13230,3411,3394,17,54,87
407,6b114d4e-8d1c-4231-b6b7-375c35069c86,44039666,13230,3496,3417,79,55,87
407,6b114d4e-8d1c-4231-b6b7-375c35069c86,44039666,13230,3900,3509,391,56,87
407,6b114d4e-8d1c-4231-b6b7-375c35069c86,44039666,13230,4173,3910,263,57,87
407,6b114d4e-8d1c-4231-b6b7-375c35069c86,44039666,13230,5186,4195,991,58,87
407,6b114d4e-8d1c-4231-b6b7-375c35069c86,44039666,13230,5384,5210,174,59,87
407,6b114d4e-8d1c-4231-b6b7-375c35069c86,44039666,13230,5595,5425,170,74,87
407,6b114d4e-8d1c-4231-b6b7-375c35069c86,44039666,13230,5870,5621,249,75,87
407,6b114d4e-8d1c-4231-b6b7-375c35069c86,44039666,13230,7580,5906,1674,76,87
407,6b114d4e-8d1c-4231-b6b7-375c35069c86,44039666,13230,7953,7609,344,77,87
407,6b114d4e-8d1c-4231-b6b7-375c35069c86,44039666,13230,8088,7962,126,78,87
407,6b114d4e-8d1c-4231-b6b7-375c35069c86,44039666,13230,8446,8093,353,79,87
407,6b114d4e-8d1c-4231-b6b7-375c35069c86,44039666,13230,8500,8450,50,81,87
407,6b114d4e-8d1c-4231-b6b7-375c35069c86,44039666,13230,9170,8501,669,82,87
407,6b114d4e-8d1c-4231-b6b7-375c35069c86,44039666,13230,10849,9194,1655,83,87
407,6b114d4e-8d1c-4231-b6b7-375c35069c86,44039666,13230,11091,10872,219,84,87
407,6b114d4e-8d1c-4231-b6b7-375c35069c86,44039666,13230,11080,10823,-257,87,87
407,6b114d4e-8d1c-4231-b6b7-375c35069c86,44044248,6780,108,6,102,0,70
407,6b114d4e-8d1c-4231-b6b7-375c35069c86,44044248,6780,124,114,10,1,70
407,6b114d4e-8d1c-4231-b6b7-375c35069c86,44044248,6780,179,129,50,2,70
407,6b114d4e-8d1c-4231-b6b7-375c35069c86,44044248,6780,348,182,166,3,70
407,6b114d4e-8d1c-4231-b6b7-375c35069c86,44044248,6780,487,352,135,4,70
407,6b114d4e-8d1c-4231-b6b7-375c35069c86,44044248,6780,823,488,335,5,70
407,6b114d4e-8d1c-4231-b6b7-375c35069c86,44044248,6780,1251,829,422,6,70
407,6b114d4e-8d1c-4231-b6b7-375c35069c86,44044248,6780,1327,1254,73,7,70
407,6b114d4e-8d1c-4231-b6b7-375c35069c86,44044248,6780,1448,1337,111,8,70
407,6b114d4e-8d1c-4231-b6b7-375c35069c86,44044248,6780,1642,1458,184,9,70
407,6b114d4e-8d1c-4231-b6b7-375c35069c86,44044248,6780,1913,1644,269,10,70
407,6b114d4e-8d1c-4231-b6b7-375c35069c86,44044248,6780,2267,1921,346,11,70
407,6b114d4e-8d1c-4231-b6b7-375c35069c86,44044248,6780,2737,2276,461,12,70
407,6b114d4e-8d1c-4231-b6b7-375c35069c86,44044248,6780,2890,2746,144,13,70
407,6b114d4e-8d1c-4231-b6b7-375c35069c86,44044248,6780,3201,2904,297,35,70
407,6b114d4e-8d1c-4231-b6b7-375c35069c86,44044248,6780,3261,3203,58,36,70
407,6b114d4e-8d1c-4231-b6b7-375c35069c86,44044248,6780,3370,3265,105,47,70
407,6b114d4e-8d1c-4231-b6b7-375c35069c86,44044248,6780,4363,3383,980,50,70
407,6b114d4e-8d1c-4231-b6b7-375c35069c86,44044248,6780,4759,4397,362,51,70
407,6b114d4e-8d1c-4231-b6b7-375c35069c86,44044248,6780,4889,4761,128,54,70
407,6b114d4e-8d1c-4231-b6b7-375c35069c86,44044248,6780,4958,4902,56,55,70
407,6b114d4e-8d1c-4231-b6b7-375c35069c86,44044248,6780,5400,4961,439,60,70
407,6b114d4e-8d1c-4231-b6b7-375c35069c86,44044248,6780,5389,5333,-56,63,70
407,6b114d4e-8d1c-4231-b6b7-375c35069c86,44044248,6780,5320,5303,-17,64,70
407,6b114d4e-8d1c-4231-b6b7-375c35069c86,44044248,6780,5400,5333,-67,65,70
407,6b114d4e-8d1c-4231-b6b7-375c35069c86,44044248,6780,5265,5039,-226,66,70
407,6b114d4e-8d1c-4231-b6b7-375c35069c86,44044248,6780,5170,4750,-420,68,70
407,6b114d4e-8d1c-4231-b6b7-375c35069c86,44044248,6780,4701,4393,-308,70,70
407,a2ad4028-7803-4df9-a5ad-5164629949e7,44024605,8607,36,5,31,0,22
407,a2ad4028-7803-4df9-a5ad-5164629949e7,44024605,8607,121,39,82,2,22
407,a2ad4028-7803-4df9-a5ad-5164629949e7,44024605,8607,198,0,-198,3,22
407,a2ad4028-7803-4df9-a5ad-5164629949e7,44024605,8607,921,215,706,4,22
407,a2ad4028-7803-4df9-a5ad-5164629949e7,44024605,8607,936,925,11,5,22
407,a2ad4028-7803-4df9-a5ad-5164629949e7,44024605,8607,916,604,-312,20,22
407,a2ad4028-7803-4df9-a5ad-5164629949e7,44024605,8607,600,507,-93,21,22
407,a2ad4028-7803-4df9-a5ad-5164629949e7,44024605,8607,1042,508,534,22,22
407,15ac2f06-2b3a-4676-9a98-0c6caf8c8460,44045424,14541,94,22,72,0,55
407,15ac2f06-2b3a-4676-9a98-0c6caf8c8460,44045424,14541,133,104,29,1,55
407,15ac2f06-2b3a-4676-9a98-0c6caf8c8460,44045424,14541,247,137,110,2,55
407,15ac2f06-2b3a-4676-9a98-0c6caf8c8460,44045424,14541,445,255,190,3,55
407,15ac2f06-2b3a-4676-9a98-0c6caf8c8460,44045424,14541,570,455,115,4,55
407,15ac2f06-2b3a-4676-9a98-0c6caf8c8460,44045424,14541,675,578,97,5,55
407,15ac2f06-2b3a-4676-9a98-0c6caf8c8460,44045424,14541,763,683,80,6,55
407,15ac2f06-2b3a-4676-9a98-0c6caf8c8460,44045424,14541,962,775,187,7,55
407,15ac2f06-2b3a-4676-9a98-0c6caf8c8460,44045424,14541,1101,971,130,8,55
407,15ac2f06-2b3a-4676-9a98-0c6caf8c8460,44045424,14541,1216,1106,110,9,55
407,15ac2f06-2b3a-4676-9a98-0c6caf8c8460,44045424,14541,1315,1220,95,10,55
407,15ac2f06-2b3a-4676-9a98-0c6caf8c8460,44045424,14541,1481,1324,157,11,55
407,15ac2f06-2b3a-4676-9a98-0c6caf8c8460,44045424,14541,1501,1485,16,12,55
407,15ac2f06-2b3a-4676-9a98-0c6caf8c8460,44045424,14541,1550,1507,43,13,55
407,15ac2f06-2b3a-4676-9a98-0c6caf8c8460,44045424,14541,1598,1556,42,14,55
407,15ac2f06-2b3a-4676-9a98-0c6caf8c8460,44045424,14541,1640,1605,35,15,55
407,15ac2f06-2b3a-4676-9a98-0c6caf8c8460,44045424,14541,1713,1641,72,18,55
407,15ac2f06-2b3a-4676-9a98-0c6caf8c8460,44045424,14541,1802,1724,78,19,55
407,15ac2f06-2b3a-4676-9a98-0c6caf8c8460,44045424,14541,1837,1804,33,20,55
407,15ac2f06-2b3a-4676-9a98-0c6caf8c8460,44045424,14541,1947,1847,100,23,55
407,15ac2f06-2b3a-4676-9a98-0c6caf8c8460,44045424,14541,2020,1948,72,24,55
407,15ac2f06-2b3a-4676-9a98-0c6caf8c8460,44045424,14541,2101,2027,74,25,55
407,15ac2f06-2b3a-4676-9a98-0c6caf8c8460,44045424,14541,2160,2103,57,31,55
407,15ac2f06-2b3a-4676-9a98-0c6caf8c8460,44045424,14541,2290,2166,124,32,55
407,15ac2f06-2b3a-4676-9a98-0c6caf8c8460,44045424,14541,2338,2297,41,33,55
407,15ac2f06-2b3a-4676-9a98-0c6caf8c8460,44045424,14541,2442,2341,101,34,55
407,15ac2f06-2b3a-4676-9a98-0c6caf8c8460,44045424,14541,2486,2452,34,35,55
407,15ac2f06-2b3a-4676-9a98-0c6caf8c8460,44045424,14541,2639,2488,151,43,55
407,15ac2f06-2b3a-4676-9a98-0c6caf8c8460,44045424,14541,2949,2647,302,47,55
407,15ac2f06-2b3a-4676-9a98-0c6caf8c8460,44045424,14541,2846,2471,-375,54,55
407,15ac2f06-2b3a-4676-9a98-0c6caf8c8460,44045424,14541,2431,1824,-607,55,55
407,15ac2f06-2b3a-4676-9a98-0c6caf8c8460,44040007,4554,43,0,-43,0,144
407,15ac2f06-2b3a-4676-9a98-0c6caf8c8460,44040007,4554,190,9,181,83,144
407,15ac2f06-2b3a-4676-9a98-0c6caf8c8460,44040007,4554,335,200,135,92,144
407,15ac2f06-2b3a-4676-9a98-0c6caf8c8460,44040007,4554,479,342,137,93,144
407,15ac2f06-2b3a-4676-9a98-0c6caf8c8460,44040007,4554,677,509,168,94,144
407,15ac2f06-2b3a-4676-9a98-0c6caf8c8460,44040007,4554,865,691,174,96,144
407,15ac2f06-2b3a-4676-9a98-0c6caf8c8460,44040007,4554,924,870,54,103,144
407,15ac2f06-2b3a-4676-9a98-0c6caf8c8460,44040007,4554,966,927,39,128,144
407,15ac2f06-2b3a-4676-9a98-0c6caf8c8460,44040007,4554,1139,980,159,135,144
407,15ac2f06-2b3a-4676-9a98-0c6caf8c8460,44040007,4554,1738,1142,596,136,144
407,15ac2f06-2b3a-4676-9a98-0c6caf8c8460,44040007,4554,1921,1762,159,137,144
407,15ac2f06-2b3a-4676-9a98-0c6caf8c8460,44040007,4554,2256,1930,326,138,144
407,15ac2f06-2b3a-4676-9a98-0c6caf8c8460,44040007,4554,2461,2283,178,139,144
407,15ac2f06-2b3a-4676-9a98-0c6caf8c8460,44040007,4554,2561,2462,99,140,144
407,15ac2f06-2b3a-4676-9a98-0c6caf8c8460,44040007,4554,2586,2563,23,141,144
407,15ac2f06-2b3a-4676-9a98-0c6caf8c8460,44040007,4554,3054,2603,451,142,144
407,15ac2f06-2b3a-4676-9a98-0c6caf8c8460,44040007,4554,3174,3059,115,144,144
407,15ac2f06-2b3a-4676-9a98-0c6caf8c8460,44038086,16011,177,12,165,0,33
407,15ac2f06-2b3a-4676-9a98-0c6caf8c8460,44038086,16011,1307,192,1115,1,33
407,15ac2f06-2b3a-4676-9a98-0c6caf8c8460,44038086,16011,1328,1316,12,2,33
407,15ac2f06-2b3a-4676-9a98-0c6caf8c8460,44038086,16011,1828,1340,488,3,33
407,15ac2f06-2b3a-4676-9a98-0c6caf8c8460,44038086,16011,2247,1834,413,4,33
407,15ac2f06-2b3a-4676-9a98-0c6caf8c8460,44038086,16011,2355,2256,99,5,33
407,15ac2f06-2b3a-4676-9a98-0c6caf8c8460,44038086,16011,2877,2381,496,9,33
407,15ac2f06-2b3a-4676-9a98-0c6caf8c8460,44038086,16011,4496,2894,1602,10,33
407,15ac2f06-2b3a-4676-9a98-0c6caf8c8460,44038086,16011,4582,4498,84,11,33
407,15ac2f06-2b3a-4676-9a98-0c6caf8c8460,44038086,16011,4667,4585,82,12,33
407,15ac2f06-2b3a-4676-9a98-0c6caf8c8460,44038086,16011,4706,4670,36,13,33
407,15ac2f06-2b3a-4676-9a98-0c6caf8c8460,44038086,16011,5515,4709,806,14,33
407,15ac2f06-2b3a-4676-9a98-0c6caf8c8460,44038086,16011,6477,5552,925,15,33
407,15ac2f06-2b3a-4676-9a98-0c6caf8c8460,44038086,16011,6796,6513,283,16,33
407,15ac2f06-2b3a-4676-9a98-0c6caf8c8460,44038086,16011,8317,6720,1597,19,33
407,15ac2f06-2b3a-4676-9a98-0c6caf8c8460,44038086,16011,8460,8328,132,20,33
407,15ac2f06-2b3a-4676-9a98-0c6caf8c8460,44038086,16011,8507,8469,38,21,33
407,15ac2f06-2b3a-4676-9a98-0c6caf8c8460,44038086,16011,8527,8510,17,22,33
407,15ac2f06-2b3a-4676-9a98-0c6caf8c8460,44038086,16011,8564,8528,36,23,33
407,15ac2f06-2b3a-4676-9a98-0c6caf8c8460,44038086,16011,8769,8579,190,24,33
407,15ac2f06-2b3a-4676-9a98-0c6caf8c8460,44038086,16011,9137,8803,334,25,33
407,15ac2f06-2b3a-4676-9a98-0c6caf8c8460,44038086,16011,9150,9142,8,26,33
407,15ac2f06-2b3a-4676-9a98-0c6caf8c8460,44038086,16011,10344,9156,1188,27,33
407,15ac2f06-2b3a-4676-9a98-0c6caf8c8460,44038086,16011,11060,10348,712,28,33
407,15ac2f06-2b3a-4676-9a98-0c6caf8c8460,44038086,16011,11376,11061,315,31,33
407,15ac2f06-2b3a-4676-9a98-0c6caf8c8460,44038086,16011,11600,11392,208,32,33
407,15ac2f06-2b3a-4676-9a98-0c6caf8c8460,44038086,16011,11688,11646,42,33,33
407,15ac2f06-2b3a-4676-9a98-0c6caf8c8460,44003853,5487,245,2,243,0,14
407,15ac2f06-2b3a-4676-9a98-0c6caf8c8460,44003853,5487,375,246,129,1,14
407,15ac2f06-2b3a-4676-9a98-0c6caf8c8460,44003853,5487,461,388,73,2,14
407,15ac2f06-2b3a-4676-9a98-0c6caf8c8460,44003853,5487,618,471,147,3,14
407,15ac2f06-2b3a-4676-9a98-0c6caf8c8460,44003853,5487,741,628,113,5,14
407,15ac2f06-2b3a-4676-9a98-0c6caf8c8460,44003853,5487,873,748,125,6,14
407,15ac2f06-2b3a-4676-9a98-0c6caf8c8460,44003853,5487,940,882,58,7,14
407,15ac2f06-2b3a-4676-9a98-0c6caf8c8460,44003853,5487,3128,945,2183,8,14
407,15ac2f06-2b3a-4676-9a98-0c6caf8c8460,44003853,5487,3678,2741,-937,9,14
407,15ac2f06-2b3a-4676-9a98-0c6caf8c8460,44003853,5487,2674,1780,-894,10,14
407,15ac2f06-2b3a-4676-9a98-0c6caf8c8460,44003853,5487,1775,1487,-288,14,14
407,f403dfd1-218a-4d8e-be95-009f92af8036,44056972,10305,644,15,629,0,1
407,f403dfd1-218a-4d8e-be95-009f92af8036,44056972,10305,3607,647,2960,1,1
409,66b37102-f0be-4d71-9f94-e5d9b7f80244,44058190,8256,233,22,211,0,25
409,66b37102-f0be-4d71-9f94-e5d9b7f80244,44058190,8256,382,238,144,1,25
409,66b37102-f0be-4d71-9f94-e5d9b7f80244,44058190,8256,463,383,80,3,25
409,66b37102-f0be-4d71-9f94-e5d9b7f80244,44058190,8256,571,473,98,4,25
409,66b37102-f0be-4d71-9f94-e5d9b7f80244,44058190,8256,632,582,50,5,25
409,66b37102-f0be-4d71-9f94-e5d9b7f80244,44058190,8256,765,638,127,7,25
409,66b37102-f0be-4d71-9f94-e5d9b7f80244,44058190,8256,899,766,133,8,25
409,66b37102-f0be-4d71-9f94-e5d9b7f80244,44058190,8256,1100,921,179,9,25
409,66b37102-f0be-4d71-9f94-e5d9b7f80244,44058190,8256,1499,1103,396,10,25
409,66b37102-f0be-4d71-9f94-e5d9b7f80244,44058190,8256,2685,1522,1163,11,25
409,66b37102-f0be-4d71-9f94-e5d9b7f80244,44058190,8256,4629,2697,1932,12,25
409,66b37102-f0be-4d71-9f94-e5d9b7f80244,44058190,8256,6224,4685,1539,13,25
409,66b37102-f0be-4d71-9f94-e5d9b7f80244,44058190,8256,6218,2855,-3363,24,25
409,66b37102-f0be-4d71-9f94-e5d9b7f80244,44058190,8256,2853,2851,-2,25,25
409,66b37102-f0be-4d71-9f94-e5d9b7f80244,44051779,11916,315,1,314,0,10
409,66b37102-f0be-4d71-9f94-e5d9b7f80244,44051779,11916,437,328,109,1,10
409,66b37102-f0be-4d71-9f94-e5d9b7f80244,44051779,11916,1881,447,1434,2,10
409,66b37102-f0be-4d71-9f94-e5d9b7f80244,44051779,11916,3115,1994,1121,3,10
409,66b37102-f0be-4d71-9f94-e5d9b7f80244,44051779,11916,3503,3275,228,4,10
409,66b37102-f0be-4d71-9f94-e5d9b7f80244,44051779,11916,3436,3071,-365,5,10
409,66b37102-f0be-4d71-9f94-e5d9b7f80244,44051779,11916,3253,3073,180,6,10
409,66b37102-f0be-4d71-9f94-e5d9b7f80244,44051779,11916,3478,3308,170,7,10
409,66b37102-f0be-4d71-9f94-e5d9b7f80244,44051779,11916,5938,3488,2450,8,10
409,66b37102-f0be-4d71-9f94-e5d9b7f80244,44051779,11916,5901,5700,-201,9,10
409,66b37102-f0be-4d71-9f94-e5d9b7f80244,44051779,11916,5654,5554,-100,10,10
409,66b37102-f0be-4d71-9f94-e5d9b7f80244,44052070,9100,191,19,172,0,6
409,66b37102-f0be-4d71-9f94-e5d9b7f80244,44052070,9100,502,190,312,1,6
409,66b37102-f0be-4d71-9f94-e5d9b7f80244,44052070,9100,1908,515,1393,2,6
409,66b37102-f0be-4d71-9f94-e5d9b7f80244,44052070,9100,2242,1931,311,3,6
409,66b37102-f0be-4d71-9f94-e5d9b7f80244,44052070,9100,2539,2272,267,4,6
409,66b37102-f0be-4d71-9f94-e5d9b7f80244,44052070,9100,3294,2575,719,5,6
409,66b37102-f0be-4d71-9f94-e5d9b7f80244,44052070,9100,5664,3361,2303,6,6
409,66b37102-f0be-4d71-9f94-e5d9b7f80244,44055362,8804,331,24,307,0,41
409,66b37102-f0be-4d71-9f94-e5d9b7f80244,44055362,8804,904,0,904,1,41
409,66b37102-f0be-4d71-9f94-e5d9b7f80244,44055362,8804,990,916,74,2,41
409,66b37102-f0be-4d71-9f94-e5d9b7f80244,44055362,8804,985,878,-107,4,41
409,66b37102-f0be-4d71-9f94-e5d9b7f80244,44055362,8804,876,739,-137,5,41
409,66b37102-f0be-4d71-9f94-e5d9b7f80244,44055362,8804,1232,753,479,7,41
409,66b37102-f0be-4d71-9f94-e5d9b7f80244,44055362,8804,1477,1243,234,8,41
409,66b37102-f0be-4d71-9f94-e5d9b7f80244,44055362,8804,1689,1471,218,9,41
409,66b37102-f0be-4d71-9f94-e5d9b7f80244,44055362,8804,1925,1693,232,10,41
409,66b37102-f0be-4d71-9f94-e5d9b7f80244,44055362,8804,2100,1936,164,11,41
409,66b37102-f0be-4d71-9f94-e5d9b7f80244,44055362,8804,2177,2106,71,12,41
409,66b37102-f0be-4d71-9f94-e5d9b7f80244,44055362,8804,2270,2184,86,13,41
409,66b37102-f0be-4d71-9f94-e5d9b7f80244,44055362,8804,2404,2281,123,14,41
409,66b37102-f0be-4d71-9f94-e5d9b7f80244,44055362,8804,2477,2405,72,15,41
409,66b37102-f0be-4d71-9f94-e5d9b7f80244,44055362,8804,2526,2485,41,16,41
409,66b37102-f0be-4d71-9f94-e5d9b7f80244,44055362,8804,2591,2529,62,17,41
409,66b37102-f0be-4d71-9f94-e5d9b7f80244,44055362,8804,2587,2464,-123,18,41
409,66b37102-f0be-4d71-9f94-e5d9b7f80244,44055362,8804,2520,2469,51,19,41
409,66b37102-f0be-4d71-9f94-e5d9b7f80244,44055362,8804,2682,2524,158,22,41
409,66b37102-f0be-4d71-9f94-e5d9b7f80244,44055362,8804,2671,2397,-274,23,41
409,66b37102-f0be-4d71-9f94-e5d9b7f80244,44055362,8804,2468,2407,61,30,41
409,66b37102-f0be-4d71-9f94-e5d9b7f80244,44055362,8804,2801,2488,313,31,41
409,66b37102-f0be-4d71-9f94-e5d9b7f80244,44055362,8804,3052,2818,234,32,41
409,66b37102-f0be-4d71-9f94-e5d9b7f80244,44055362,8804,3232,3055,177,33,41
409,66b37102-f0be-4d71-9f94-e5d9b7f80244,44055362,8804,3358,3226,132,34,41
409,66b37102-f0be-4d71-9f94-e5d9b7f80244,44055362,8804,3628,3372,256,35,41
409,66b37102-f0be-4d71-9f94-e5d9b7f80244,44055362,8804,3760,3630,130,36,41
409,66b37102-f0be-4d71-9f94-e5d9b7f80244,44055362,8804,3979,3770,209,37,41
409,66b37102-f0be-4d71-9f94-e5d9b7f80244,44055362,8804,4044,3989,55,38,41
409,66b37102-f0be-4d71-9f94-e5d9b7f80244,44055362,8804,4114,4047,67,39,41
409,66b37102-f0be-4d71-9f94-e5d9b7f80244,44055362,8804,4492,4131,361,40,41
409,66b37102-f0be-4d71-9f94-e5d9b7f80244,44055362,8804,6772,4519,2253,41,41
409,66b37102-f0be-4d71-9f94-e5d9b7f80244,44044248,12548,25,1,24,0,22
409,66b37102-f0be-4d71-9f94-e5d9b7f80244,44044248,12548,28,26,2,1,22
409,66b37102-f0be-4d71-9f94-e5d9b7f80244,44044248,12548,30,30,0,2,22
409,66b37102-f0be-4d71-9f94-e5d9b7f80244,44044248,12548,309,32,277,3,22
409,66b37102-f0be-4d71-9f94-e5d9b7f80244,44044248,12548,519,329,190,4,22
409,66b37102-f0be-4d71-9f94-e5d9b7f80244,44044248,12548,805,537,268,5,22
409,66b37102-f0be-4d71-9f94-e5d9b7f80244,44044248,12548,983,822,161,11,22
409,66b37102-f0be-4d71-9f94-e5d9b7f80244,44044248,12548,1389,1127,262,12,22
409,66b37102-f0be-4d71-9f94-e5d9b7f80244,44044248,12548,1491,1398,93,13,22
409,66b37102-f0be-4d71-9f94-e5d9b7f80244,44044248,12548,1757,1499,258,14,22
409,66b37102-f0be-4d71-9f94-e5d9b7f80244,44044248,12548,2528,1759,769,15,22
409,66b37102-f0be-4d71-9f94-e5d9b7f80244,44044248,12548,3408,2543,865,16,22
409,66b37102-f0be-4d71-9f94-e5d9b7f80244,44044248,12548,3763,3417,346,17,22
409,66b37102-f0be-4d71-9f94-e5d9b7f80244,44044248,12548,5397,3778,1619,18,22
409,66b37102-f0be-4d71-9f94-e5d9b7f80244,44044248,12548,5469,5411,58,19,22
409,66b37102-f0be-4d71-9f94-e5d9b7f80244,44044248,12548,5540,5472,68,20,22
409,66b37102-f0be-4d71-9f94-e5d9b7f80244,44044248,12548,7306,5541,1765,21,22
409,66b37102-f0be-4d71-9f94-e5d9b7f80244,44044248,12548,8289,7320,969,22,22
408,f263b22f-c738-4e9b-8cfe-c8b8a7b42b93,44088032,4443,184,4,180,0,16
408,f263b22f-c738-4e9b-8cfe-c8b8a7b42b93,44088032,4443,466,168,298,1,16
408,f263b22f-c738-4e9b-8cfe-c8b8a7b42b93,44088032,4443,812,320,-492,2,16
408,f263b22f-c738-4e9b-8cfe-c8b8a7b42b93,44088032,4443,220,0,-220,3,16
408,f263b22f-c738-4e9b-8cfe-c8b8a7b42b93,44088032,4443,225,4,221,6,16
408,f263b22f-c738-4e9b-8cfe-c8b8a7b42b93,44088032,4443,583,232,351,7,16
408,f263b22f-c738-4e9b-8cfe-c8b8a7b42b93,44088032,4443,1538,601,937,8,16
408,f263b22f-c738-4e9b-8cfe-c8b8a7b42b93,44088032,4443,3331,1625,1706,9,16
408,f263b22f-c738-4e9b-8cfe-c8b8a7b42b93,44088032,4443,3683,3350,333,10,16
408,f263b22f-c738-4e9b-8cfe-c8b8a7b42b93,44088032,4443,3680,3637,-43,13,16
408,f263b22f-c738-4e9b-8cfe-c8b8a7b42b93,44088032,4443,3635,3596,-39,14,16
408,f263b22f-c738-4e9b-8cfe-c8b8a7b42b93,44088032,4443,3594,3257,-337,15,16
408,f263b22f-c738-4e9b-8cfe-c8b8a7b42b93,44088032,4443,3255,3252,-3,16,16
410,309ffda2-1cce-4c29-9af8-73933a2dd59a,44102158,7107,294,5,289,0,106
410,309ffda2-1cce-4c29-9af8-73933a2dd59a,44102158,7107,388,302,86,3,106
410,309ffda2-1cce-4c29-9af8-73933a2dd59a,44102158,7107,540,422,118,4,106
410,309ffda2-1cce-4c29-9af8-73933a2dd59a,44102158,7107,632,549,83,5,106
410,309ffda2-1cce-4c29-9af8-73933a2dd59a,44102158,7107,704,643,61,6,106
410,309ffda2-1cce-4c29-9af8-73933a2dd59a,44102158,7107,717,709,8,7,106
410,309ffda2-1cce-4c29-9af8-73933a2dd59a,44102158,7107,778,729,49,9,106
410,309ffda2-1cce-4c29-9af8-73933a2dd59a,44102158,7107,884,785,99,10,106
410,309ffda2-1cce-4c29-9af8-73933a2dd59a,44102158,7107,968,896,72,11,106
410,309ffda2-1cce-4c29-9af8-73933a2dd59a,44102158,7107,1045,983,62,12,106
410,309ffda2-1cce-4c29-9af8-73933a2dd59a,44102158,7107,1159,1057,102,13,106
410,309ffda2-1cce-4c29-9af8-73933a2dd59a,44102158,7107,1264,1163,101,14,106
410,309ffda2-1cce-4c29-9af8-73933a2dd59a,44102158,7107,1332,1267,65,16,106
410,309ffda2-1cce-4c29-9af8-73933a2dd59a,44102158,7107,1390,1335,55,20,106
410,309ffda2-1cce-4c29-9af8-73933a2dd59a,44102158,7107,1439,1391,48,21,106
410,309ffda2-1cce-4c29-9af8-73933a2dd59a,44102158,7107,1559,1451,108,23,106
410,309ffda2-1cce-4c29-9af8-73933a2dd59a,44102158,7107,1617,1591,26,24,106
410,309ffda2-1cce-4c29-9af8-73933a2dd59a,44102158,7107,1694,1624,70,29,106
410,309ffda2-1cce-4c29-9af8-73933a2dd59a,44102158,7107,1771,1696,75,40,106
410,309ffda2-1cce-4c29-9af8-73933a2dd59a,44102158,7107,1835,1780,55,42,106
410,309ffda2-1cce-4c29-9af8-73933a2dd59a,44102158,7107,1912,1846,66,46,106
410,309ffda2-1cce-4c29-9af8-73933a2dd59a,44102158,7107,1913,1913,0,47,106
410,309ffda2-1cce-4c29-9af8-73933a2dd59a,44102158,7107,1970,1915,55,48,106
410,309ffda2-1cce-4c29-9af8-73933a2dd59a,44102158,7107,2065,1982,83,50,106
410,309ffda2-1cce-4c29-9af8-73933a2dd59a,44102158,7107,2147,2069,78,53,106
410,309ffda2-1cce-4c29-9af8-73933a2dd59a,44102158,7107,2180,2149,31,54,106
410,309ffda2-1cce-4c29-9af8-73933a2dd59a,44102158,7107,2266,2181,85,57,106
410,309ffda2-1cce-4c29-9af8-73933a2dd59a,44102158,7107,2348,2269,79,58,106
410,309ffda2-1cce-4c29-9af8-73933a2dd59a,44102158,7107,2414,2356,58,59,106
410,309ffda2-1cce-4c29-9af8-73933a2dd59a,44102158,7107,2493,2417,76,60,106
410,309ffda2-1cce-4c29-9af8-73933a2dd59a,44102158,7107,2584,2496,88,63,106
410,309ffda2-1cce-4c29-9af8-73933a2dd59a,44102158,7107,2658,2593,65,64,106
410,309ffda2-1cce-4c29-9af8-73933a2dd59a,44102158,7107,2751,2673,78,69,106
410,309ffda2-1cce-4c29-9af8-73933a2dd59a,44102158,7107,2834,2758,76,74,106
410,309ffda2-1cce-4c29-9af8-73933a2dd59a,44102158,7107,2920,2849,71,75,106
410,309ffda2-1cce-4c29-9af8-73933a2dd59a,44102158,7107,3160,2933,227,76,106
410,309ffda2-1cce-4c29-9af8-73933a2dd59a,44102158,7107,3317,3167,150,77,106
410,309ffda2-1cce-4c29-9af8-73933a2dd59a,44102158,7107,3444,3330,114,78,106
410,309ffda2-1cce-4c29-9af8-73933a2dd59a,44102158,7107,3552,3455,97,79,106
410,309ffda2-1cce-4c29-9af8-73933a2dd59a,44102158,7107,3641,3554,87,80,106
410,309ffda2-1cce-4c29-9af8-73933a2dd59a,44102158,7107,3719,3646,73,82,106
410,309ffda2-1cce-4c29-9af8-73933a2dd59a,44102158,7107,3797,3734,63,83,106
410,309ffda2-1cce-4c29-9af8-73933a2dd59a,44102158,7107,3897,3810,87,87,106
410,309ffda2-1cce-4c29-9af8-73933a2dd59a,44102158,7107,3964,3901,63,88,106
410,309ffda2-1cce-4c29-9af8-73933a2dd59a,44102158,7107,4058,3972,86,89,106
410,309ffda2-1cce-4c29-9af8-73933a2dd59a,44102158,7107,4157,4062,95,91,106
410,309ffda2-1cce-4c29-9af8-73933a2dd59a,44102158,7107,4302,4162,140,92,106
410,309ffda2-1cce-4c29-9af8-73933a2dd59a,44102158,7107,4374,4303,71,93,106
410,309ffda2-1cce-4c29-9af8-73933a2dd59a,44102158,7107,4702,4377,325,94,106
410,309ffda2-1cce-4c29-9af8-73933a2dd59a,44102158,7107,4805,4719,86,95,106
410,309ffda2-1cce-4c29-9af8-73933a2dd59a,44102158,7107,4879,4808,71,97,106
410,309ffda2-1cce-4c29-9af8-73933a2dd59a,44102158,7107,4948,4881,67,98,106
410,309ffda2-1cce-4c29-9af8-73933a2dd59a,44102158,7107,5004,4950,54,99,106
410,309ffda2-1cce-4c29-9af8-73933a2dd59a,44102158,7107,5077,5011,66,102,106
410,309ffda2-1cce-4c29-9af8-73933a2dd59a,44102158,7107,5157,5083,74,103,106
410,309ffda2-1cce-4c29-9af8-73933a2dd59a,44102158,7107,5162,5162,0,104,106
410,309ffda2-1cce-4c29-9af8-73933a2dd59a,44102158,7107,5355,5174,181,105,106
410,309ffda2-1cce-4c29-9af8-73933a2dd59a,44102158,7107,5586,5380,206,106,106
411,eb74b06d-d481-4ec3-a294-55ed9bfae78d,44089161,9246,466,3,463,0,16
411,eb74b06d-d481-4ec3-a294-55ed9bfae78d,44089161,9246,482,470,12,1,16
411,eb74b06d-d481-4ec3-a294-55ed9bfae78d,44089161,9246,594,483,111,7,16
411,eb74b06d-d481-4ec3-a294-55ed9bfae78d,44089161,9246,834,596,238,8,16
411,eb74b06d-d481-4ec3-a294-55ed9bfae78d,44089161,9246,1751,865,886,9,16
411,eb74b06d-d481-4ec3-a294-55ed9bfae78d,44089161,9246,2479,1765,714,13,16
411,eb74b06d-d481-4ec3-a294-55ed9bfae78d,44089161,9246,3291,2519,772,14,16
411,eb74b06d-d481-4ec3-a294-55ed9bfae78d,44089161,9246,3316,3296,20,15,16
411,eb74b06d-d481-4ec3-a294-55ed9bfae78d,44089161,9246,3310,3003,-307,16,16
411,eb74b06d-d481-4ec3-a294-55ed9bfae78d,44117335,7971,94,10,84,0,93
411,eb74b06d-d481-4ec3-a294-55ed9bfae78d,44117335,7971,105,95,10,1,93
411,eb74b06d-d481-4ec3-a294-55ed9bfae78d,44117335,7971,192,118,74,4,93
411,eb74b06d-d481-4ec3-a294-55ed9bfae78d,44117335,7971,270,204,66,5,93
411,eb74b06d-d481-4ec3-a294-55ed9bfae78d,44117335,7971,459,284,175,6,93
411,eb74b06d-d481-4ec3-a294-55ed9bfae78d,44117335,7971,536,464,72,7,93
411,eb74b06d-d481-4ec3-a294-55ed9bfae78d,44117335,7971,552,537,15,8,93
411,eb74b06d-d481-4ec3-a294-55ed9bfae78d,44117335,7971,715,560,155,17,93
411,eb74b06d-d481-4ec3-a294-55ed9bfae78d,44117335,7971,733,720,13,18,93
411,eb74b06d-d481-4ec3-a294-55ed9bfae78d,44117335,7971,813,736,77,20,93
411,eb74b06d-d481-4ec3-a294-55ed9bfae78d,44117335,7971,1047,830,217,24,93
411,eb74b06d-d481-4ec3-a294-55ed9bfae78d,44117335,7971,1266,1064,202,29,93
411,eb74b06d-d481-4ec3-a294-55ed9bfae78d,44117335,7971,1557,1278,279,30,93
411,eb74b06d-d481-4ec3-a294-55ed9bfae78d,44117335,7971,1846,1559,287,31,93
411,eb74b06d-d481-4ec3-a294-55ed9bfae78d,44117335,7971,1919,1850,69,32,93
411,eb74b06d-d481-4ec3-a294-55ed9bfae78d,44117335,7971,2142,1939,203,33,93
411,eb74b06d-d481-4ec3-a294-55ed9bfae78d,44117335,7971,2180,2152,28,34,93
411,eb74b06d-d481-4ec3-a294-55ed9bfae78d,44117335,7971,2345,2190,155,37,93
411,eb74b06d-d481-4ec3-a294-55ed9bfae78d,44117335,7971,2408,2355,53,38,93
411,eb74b06d-d481-4ec3-a294-55ed9bfae78d,44117335,7971,2443,2411,32,39,93
411,eb74b06d-d481-4ec3-a294-55ed9bfae78d,44117335,7971,2483,2451,32,40,93
411,eb74b06d-d481-4ec3-a294-55ed9bfae78d,44117335,7971,2568,2487,81,41,93
411,eb74b06d-d481-4ec3-a294-55ed9bfae78d,44117335,7971,2632,2575,57,42,93
411,eb74b06d-d481-4ec3-a294-55ed9bfae78d,44117335,7971,2686,2639,47,44,93
411,eb74b06d-d481-4ec3-a294-55ed9bfae78d,44117335,7971,2967,2692,275,45,93
411,eb74b06d-d481-4ec3-a294-55ed9bfae78d,44117335,7971,3120,2970,150,46,93
411,eb74b06d-d481-4ec3-a294-55ed9bfae78d,44117335,7971,3187,3124,63,47,93
411,eb74b06d-d481-4ec3-a294-55ed9bfae78d,44117335,7971,3246,3188,58,48,93
411,eb74b06d-d481-4ec3-a294-55ed9bfae78d,44117335,7971,3315,3259,56,56,93
411,eb74b06d-d481-4ec3-a294-55ed9bfae78d,44117335,7971,3400,3319,81,57,93
411,eb74b06d-d481-4ec3-a294-55ed9bfae78d,44117335,7971,3446,3409,37,58,93
411,eb74b06d-d481-4ec3-a294-55ed9bfae78d,44117335,7971,4597,3464,1133,64,93
411,eb74b06d-d481-4ec3-a294-55ed9bfae78d,44117335,7971,5093,4602,491,65,93
411,eb74b06d-d481-4ec3-a294-55ed9bfae78d,44117335,7971,5210,5115,95,90,93
411,eb74b06d-d481-4ec3-a294-55ed9bfae78d,44117335,7971,5427,5243,184,93,93
411,eb74b06d-d481-4ec3-a294-55ed9bfae78d,44081393,5415,115,17,98,0,68
411,eb74b06d-d481-4ec3-a294-55ed9bfae78d,44081393,5415,157,119,38,1,68
411,eb74b06d-d481-4ec3-a294-55ed9bfae78d,44081393,5415,251,159,92,2,68
411,eb74b06d-d481-4ec3-a294-55ed9bfae78d,44081393,5415,511,256,255,3,68
411,eb74b06d-d481-4ec3-a294-55ed9bfae78d,44081393,5415,663,525,138,4,68
411,eb74b06d-d481-4ec3-a294-55ed9bfae78d,44081393,5415,799,668,131,5,68
411,eb74b06d-d481-4ec3-a294-55ed9bfae78d,44081393,5415,934,805,129,6,68
411,eb74b06d-d481-4ec3-a294-55ed9bfae78d,44081393,5415,1037,935,102,7,68
411,eb74b06d-d481-4ec3-a294-55ed9bfae78d,44081393,5415,1140,1041,99,8,68
411,eb74b06d-d481-4ec3-a294-55ed9bfae78d,44081393,5415,1260,1142,118,9,68
411,eb74b06d-d481-4ec3-a294-55ed9bfae78d,44081393,5415,1301,1262,39,10,68
411,eb74b06d-d481-4ec3-a294-55ed9bfae78d,44081393,5415,1378,1305,73,11,68
411,eb74b06d-d481-4ec3-a294-55ed9bfae78d,44081393,5415,1393,1381,12,12,68
411,eb74b06d-d481-4ec3-a294-55ed9bfae78d,44081393,5415,1500,1400,100,13,68
411,eb74b06d-d481-4ec3-a294-55ed9bfae78d,44081393,5415,1578,1510,68,14,68
411,eb74b06d-d481-4ec3-a294-55ed9bfae78d,44081393,5415,1624,1587,37,18,68
411,eb74b06d-d481-4ec3-a294-55ed9bfae78d,44081393,5415,1691,1636,55,19,68
411,eb74b06d-d481-4ec3-a294-55ed9bfae78d,44081393,5415,1753,1695,58,20,68
411,eb74b06d-d481-4ec3-a294-55ed9bfae78d,44081393,5415,1896,1763,133,21,68
411,eb74b06d-d481-4ec3-a294-55ed9bfae78d,44081393,5415,1949,1897,52,22,68
411,eb74b06d-d481-4ec3-a294-55ed9bfae78d,44081393,5415,2043,1952,91,23,68
411,eb74b06d-d481-4ec3-a294-55ed9bfae78d,44081393,5415,2090,2053,37,24,68
411,eb74b06d-d481-4ec3-a294-55ed9bfae78d,44081393,5415,2163,2095,68,25,68
411,eb74b06d-d481-4ec3-a294-55ed9bfae78d,44081393,5415,2243,2164,79,26,68
411,eb74b06d-d481-4ec3-a294-55ed9bfae78d,44081393,5415,2272,2245,27,30,68
411,eb74b06d-d481-4ec3-a294-55ed9bfae78d,44081393,5415,2310,2281,29,31,68
411,eb74b06d-d481-4ec3-a294-55ed9bfae78d,44081393,5415,2325,2316,9,32,68
411,eb74b06d-d481-4ec3-a294-55ed9bfae78d,44081393,5415,2342,2332,10,33,68
411,eb74b06d-d481-4ec3-a294-55ed9bfae78d,44081393,5415,2353,2346,7,34,68
411,eb74b06d-d481-4ec3-a294-55ed9bfae78d,44081393,5415,2383,2354,29,35,68
411,eb74b06d-d481-4ec3-a294-55ed9bfae78d,44081393,5415,2419,2386,33,36,68
411,eb74b06d-d481-4ec3-a294-55ed9bfae78d,44081393,5415,2491,2430,61,37,68
411,eb74b06d-d481-4ec3-a294-55ed9bfae78d,44081393,5415,2690,2504,186,38,68
411,eb74b06d-d481-4ec3-a294-55ed9bfae78d,44081393,5415,2839,2691,148,40,68
411,eb74b06d-d481-4ec3-a294-55ed9bfae78d,44081393,5415,2889,2840,49,41,68
411,eb74b06d-d481-4ec3-a294-55ed9bfae78d,44081393,5415,2942,2892,50,47,68
411,eb74b06d-d481-4ec3-a294-55ed9bfae78d,44081393,5415,2956,2944,12,48,68
411,eb74b06d-d481-4ec3-a294-55ed9bfae78d,44081393,5415,2983,2957,26,49,68
411,eb74b06d-d481-4ec3-a294-55ed9bfae78d,44081393,5415,3065,2987,78,52,68
411,eb74b06d-d481-4ec3-a294-55ed9bfae78d,44081393,5415,3249,3070,179,53,68
411,eb74b06d-d481-4ec3-a294-55ed9bfae78d,44081393,5415,3314,3255,59,54,68
411,eb74b06d-d481-4ec3-a294-55ed9bfae78d,44081393,5415,3357,3318,39,55,68
411,eb74b06d-d481-4ec3-a294-55ed9bfae78d,44081393,5415,3480,3367,113,56,68
411,eb74b06d-d481-4ec3-a294-55ed9bfae78d,44081393,5415,3576,3488,88,57,68
411,eb74b06d-d481-4ec3-a294-55ed9bfae78d,44081393,5415,3644,3582,62,58,68
411,eb74b06d-d481-4ec3-a294-55ed9bfae78d,44081393,5415,3758,3646,112,59,68
411,eb74b06d-d481-4ec3-a294-55ed9bfae78d,44081393,5415,3776,3762,14,60,68
411,eb74b06d-d481-4ec3-a294-55ed9bfae78d,44081393,5415,3834,3778,56,64,68
411,eb74b06d-d481-4ec3-a294-55ed9bfae78d,44081393,5415,3852,3835,17,65,68
411,eb74b06d-d481-4ec3-a294-55ed9bfae78d,44081393,5415,3950,3856,94,66,68
411,eb74b06d-d481-4ec3-a294-55ed9bfae78d,44081393,5415,4018,3954,64,67,68
411,eb74b06d-d481-4ec3-a294-55ed9bfae78d,44081393,5415,4035,4020,15,68,68
411,eb74b06d-d481-4ec3-a294-55ed9bfae78d,44115166,9096,119,9,110,0,30
411,eb74b06d-d481-4ec3-a294-55ed9bfae78d,44115166,9096,163,120,43,2,30
411,eb74b06d-d481-4ec3-a294-55ed9bfae78d,44115166,9096,184,167,17,3,30
411,eb74b06d-d481-4ec3-a294-55ed9bfae78d,44115166,9096,230,189,41,4,30
411,eb74b06d-d481-4ec3-a294-55ed9bfae78d,44115166,9096,280,239,41,5,30
411,eb74b06d-d481-4ec3-a294-55ed9bfae78d,44115166,9096,365,282,83,6,30
411,eb74b06d-d481-4ec3-a294-55ed9bfae78d,44115166,9096,447,372,75,7,30
411,eb74b06d-d481-4ec3-a294-55ed9bfae78d,44115166,9096,517,449,68,8,30
411,eb74b06d-d481-4ec3-a294-55ed9bfae78d,44115166,9096,586,529,57,9,30
411,eb74b06d-d481-4ec3-a294-55ed9bfae78d,44115166,9096,648,591,57,13,30
411,eb74b06d-d481-4ec3-a294-55ed9bfae78d,44115166,9096,758,650,108,14,30
411,eb74b06d-d481-4ec3-a294-55ed9bfae78d,44115166,9096,853,768,85,15,30
411,eb74b06d-d481-4ec3-a294-55ed9bfae78d,44115166,9096,962,861,101,16,30
411,eb74b06d-d481-4ec3-a294-55ed9bfae78d,44115166,9096,1259,963,296,17,30
411,eb74b06d-d481-4ec3-a294-55ed9bfae78d,44115166,9096,1440,1269,171,18,30
411,eb74b06d-d481-4ec3-a294-55ed9bfae78d,44115166,9096,1644,1458,186,19,30
411,eb74b06d-d481-4ec3-a294-55ed9bfae78d,44115166,9096,1705,1647,58,20,30
411,eb74b06d-d481-4ec3-a294-55ed9bfae78d,44115166,9096,1758,1706,52,23,30
411,eb74b06d-d481-4ec3-a294-55ed9bfae78d,44115166,9096,1775,1761,14,24,30
411,eb74b06d-d481-4ec3-a294-55ed9bfae78d,44115166,9096,1832,1785,47,25,30
411,eb74b06d-d481-4ec3-a294-55ed9bfae78d,44115166,9096,2062,1852,210,26,30
411,eb74b06d-d481-4ec3-a294-55ed9bfae78d,44115166,9096,2695,2065,630,27,30
411,eb74b06d-d481-4ec3-a294-55ed9bfae78d,44115166,9096,4051,2735,1316,28,30
411,eb74b06d-d481-4ec3-a294-55ed9bfae78d,44115166,9096,5942,4055,1887,29,30
411,eb74b06d-d481-4ec3-a294-55ed9bfae78d,44115166,9096,7716,5958,1758,30,30
411,eb74b06d-d481-4ec3-a294-55ed9bfae78d,44109420,1452,72,8,64,0,0
410,7f828046-9b3d-4864-b8cf-a74842349374,44116340,11292,439,28,411,0,31
410,7f828046-9b3d-4864-b8cf-a74842349374,44116340,11292,503,472,31,1,31
410,7f828046-9b3d-4864-b8cf-a74842349374,44116340,11292,594,516,78,2,31
410,7f828046-9b3d-4864-b8cf-a74842349374,44116340,11292,1527,624,903,26,31
410,7f828046-9b3d-4864-b8cf-a74842349374,44116340,11292,1748,1560,188,27,31
410,7f828046-9b3d-4864-b8cf-a74842349374,44116340,11292,1963,1755,208,28,31
410,7f828046-9b3d-4864-b8cf-a74842349374,44116340,11292,2240,1988,252,29,31
410,7f828046-9b3d-4864-b8cf-a74842349374,44116340,11292,3598,2268,1330,30,31
410,7f828046-9b3d-4864-b8cf-a74842349374,44116340,11292,4197,3622,575,31,31
411,7d2792b3-b1e5-4099-be2c-df707fb42d0b,44113324,9588,106,13,93,0,49
411,7d2792b3-b1e5-4099-be2c-df707fb42d0b,44113324,9588,340,110,230,1,49
411,7d2792b3-b1e5-4099-be2c-df707fb42d0b,44113324,9588,510,348,162,2,49
411,7d2792b3-b1e5-4099-be2c-df707fb42d0b,44113324,9588,584,514,70,3,49
411,7d2792b3-b1e5-4099-be2c-df707fb42d0b,44113324,9588,738,592,146,4,49
411,7d2792b3-b1e5-4099-be2c-df707fb42d0b,44113324,9588,1105,743,362,5,49
411,7d2792b3-b1e5-4099-be2c-df707fb42d0b,44113324,9588,1158,1115,43,6,49
411,7d2792b3-b1e5-4099-be2c-df707fb42d0b,44113324,9588,2023,1162,861,25,49
411,7d2792b3-b1e5-4099-be2c-df707fb42d0b,44113324,9588,2109,2034,75,26,49
411,7d2792b3-b1e5-4099-be2c-df707fb42d0b,44113324,9588,2738,2121,617,41,49
411,7d2792b3-b1e5-4099-be2c-df707fb42d0b,44113324,9588,2960,2762,198,42,49
411,7d2792b3-b1e5-4099-be2c-df707fb42d0b,44113324,9588,3529,2997,532,43,49
411,7d2792b3-b1e5-4099-be2c-df707fb42d0b,44113324,9588,3621,3540,81,44,49
411,7d2792b3-b1e5-4099-be2c-df707fb42d0b,44113324,9588,3675,3624,51,45,49
411,7d2792b3-b1e5-4099-be2c-df707fb42d0b,44113324,9588,3939,3679,260,46,49
411,7d2792b3-b1e5-4099-be2c-df707fb42d0b,44113324,9588,4265,3940,325,47,49
411,7d2792b3-b1e5-4099-be2c-df707fb42d0b,44113324,9588,5702,4296,1406,48,49
411,7d2792b3-b1e5-4099-be2c-df707fb42d0b,44113324,9588,6395,5762,633,49,49
411,7d2792b3-b1e5-4099-be2c-df707fb42d0b,44124546,4998,246,9,237,0,22
411,7d2792b3-b1e5-4099-be2c-df707fb42d0b,44124546,4998,273,247,26,1,22
411,7d2792b3-b1e5-4099-be2c-df707fb42d0b,44124546,4998,335,278,57,2,22
411,7d2792b3-b1e5-4099-be2c-df707fb42d0b,44124546,4998,402,337,65,3,22
411,7d2792b3-b1e5-4099-be2c-df707fb42d0b,44124546,4998,1072,425,647,7,22
411,7d2792b3-b1e5-4099-be2c-df707fb42d0b,44124546,4998,1101,1078,23,8,22
411,7d2792b3-b1e5-4099-be2c-df707fb42d0b,44124546,4998,1757,1158,599,20,22
411,7d2792b3-b1e5-4099-be2c-df707fb42d0b,44124546,4998,2435,1783,652,21,22
411,7d2792b3-b1e5-4099-be2c-df707fb42d0b,44124546,4998,2749,2466,283,22,22
411,7d2792b3-b1e5-4099-be2c-df707fb42d0b,44134910,9939,663,2,661,0,22
411,7d2792b3-b1e5-4099-be2c-df707fb42d0b,44134910,9939,670,666,4,1,22
411,7d2792b3-b1e5-4099-be2c-df707fb42d0b,44134910,9939,1442,688,754,11,22
411,7d2792b3-b1e5-4099-be2c-df707fb42d0b,44134910,9939,2444,1478,966,12,22
411,7d2792b3-b1e5-4099-be2c-df707fb42d0b,44134910,9939,3414,2464,950,13,22
411,7d2792b3-b1e5-4099-be2c-df707fb42d0b,44134910,9939,4144,3430,714,14,22
411,7d2792b3-b1e5-4099-be2c-df707fb42d0b,44134910,9939,4688,4166,522,15,22
411,7d2792b3-b1e5-4099-be2c-df707fb42d0b,44134910,9939,5274,4718,556,16,22
411,7d2792b3-b1e5-4099-be2c-df707fb42d0b,44134910,9939,5684,5276,408,17,22
411,7d2792b3-b1e5-4099-be2c-df707fb42d0b,44134910,9939,6373,5690,683,18,22
411,7d2792b3-b1e5-4099-be2c-df707fb42d0b,44134910,9939,7117,6376,741,19,22
411,7d2792b3-b1e5-4099-be2c-df707fb42d0b,44134910,9939,7298,7130,168,20,22
411,7d2792b3-b1e5-4099-be2c-df707fb42d0b,44134910,9939,7920,7339,581,21,22
411,7d2792b3-b1e5-4099-be2c-df707fb42d0b,44134910,9939,7944,7925,19,22,22
412,0c293e50-dcb7-48b1-98d7-e63b96d51202,44134910,9939,489,42,447,0,126
412,0c293e50-dcb7-48b1-98d7-e63b96d51202,44134910,9939,560,497,63,1,126
412,0c293e50-dcb7-48b1-98d7-e63b96d51202,44134910,9939,1187,576,611,9,126
412,0c293e50-dcb7-48b1-98d7-e63b96d51202,44134910,9939,1191,1190,1,10,126
412,0c293e50-dcb7-48b1-98d7-e63b96d51202,44134910,9939,1698,1208,490,17,126
412,0c293e50-dcb7-48b1-98d7-e63b96d51202,44134910,9939,1778,1706,72,18,126
412,0c293e50-dcb7-48b1-98d7-e63b96d51202,44134910,9939,2256,1784,472,32,126
412,0c293e50-dcb7-48b1-98d7-e63b96d51202,44134910,9939,2548,2280,268,33,126
412,0c293e50-dcb7-48b1-98d7-e63b96d51202,44134910,9939,2682,2573,109,34,126
412,0c293e50-dcb7-48b1-98d7-e63b96d51202,44134910,9939,3532,2700,832,52,126
412,0c293e50-dcb7-48b1-98d7-e63b96d51202,44134910,9939,3553,3537,16,53,126
412,0c293e50-dcb7-48b1-98d7-e63b96d51202,44134910,9939,4051,3574,477,77,126
412,0c293e50-dcb7-48b1-98d7-e63b96d51202,44134910,9939,4468,4116,352,80,126
412,0c293e50-dcb7-48b1-98d7-e63b96d51202,44134910,9939,4773,4540,233,85,126
412,0c293e50-dcb7-48b1-98d7-e63b96d51202,44134910,9939,5312,4821,491,86,126
412,0c293e50-dcb7-48b1-98d7-e63b96d51202,44134910,9939,5824,5331,493,98,126
412,0c293e50-dcb7-48b1-98d7-e63b96d51202,44134910,9939,6496,5854,642,106,126
412,0c293e50-dcb7-48b1-98d7-e63b96d51202,44134910,9939,6498,6497,1,107,126
412,0c293e50-dcb7-48b1-98d7-e63b96d51202,44134910,9939,7156,6535,621,118,126
412,0c293e50-dcb7-48b1-98d7-e63b96d51202,44134910,9939,7844,7161,683,124,126
412,0c293e50-dcb7-48b1-98d7-e63b96d51202,44134910,9939,8022,7897,125,125,126
412,0c293e50-dcb7-48b1-98d7-e63b96d51202,44134910,9939,8415,8100,315,126,126
412,0c293e50-dcb7-48b1-98d7-e63b96d51202,44109371,5778,84,8,76,0,18
412,0c293e50-dcb7-48b1-98d7-e63b96d51202,44109371,5778,519,67,452,10,18
412,0c293e50-dcb7-48b1-98d7-e63b96d51202,44109371,5778,529,521,8,11,18
412,0c293e50-dcb7-48b1-98d7-e63b96d51202,44109371,5778,627,542,85,13,18
412,0c293e50-dcb7-48b1-98d7-e63b96d51202,44109371,5778,1022,650,372,14,18
412,0c293e50-dcb7-48b1-98d7-e63b96d51202,44109371,5778,1443,1039,404,17,18
412,0c293e50-dcb7-48b1-98d7-e63b96d51202,44109371,5778,1715,1464,251,18,18
412,0c293e50-dcb7-48b1-98d7-e63b96d51202,44089161,9699,473,30,443,0,53
412,0c293e50-dcb7-48b1-98d7-e63b96d51202,44089161,9699,546,483,63,1,53
412,0c293e50-dcb7-48b1-98d7-e63b96d51202,44089161,9699,860,554,306,7,53
412,0c293e50-dcb7-48b1-98d7-e63b96d51202,44089161,9699,1145,885,260,8,53
412,0c293e50-dcb7-48b1-98d7-e63b96d51202,44089161,9699,1506,1174,332,13,53
412,0c293e50-dcb7-48b1-98d7-e63b96d51202,44089161,9699,1658,1536,122,14,53
412,0c293e50-dcb7-48b1-98d7-e63b96d51202,44089161,9699,2169,1674,495,25,53
412,0c293e50-dcb7-48b1-98d7-e63b96d51202,44089161,9699,2186,2174,12,26,53
412,0c293e50-dcb7-48b1-98d7-e63b96d51202,44089161,9699,2822,2226,596,33,53
412,0c293e50-dcb7-48b1-98d7-e63b96d51202,44089161,9699,2892,2834,58,34,53
412,0c293e50-dcb7-48b1-98d7-e63b96d51202,44089161,9699,3685,2928,757,43,53
412,0c293e50-dcb7-48b1-98d7-e63b96d51202,44089161,9699,4281,3688,593,45,53
412,0c293e50-dcb7-48b1-98d7-e63b96d51202,44089161,9699,4887,4314,573,46,53
412,0c293e50-dcb7-48b1-98d7-e63b96d51202,44089161,9699,4914,4893,21,47,53
412,0c293e50-dcb7-48b1-98d7-e63b96d51202,44089161,9699,5317,5032,285,50,53
412,0c293e50-dcb7-48b1-98d7-e63b96d51202,44089161,9699,6449,5360,1089,51,53
412,0c293e50-dcb7-48b1-98d7-e63b96d51202,44089161,9699,7655,6456,1199,52,53
412,0c293e50-dcb7-48b1-98d7-e63b96d51202,44089161,9699,8175,7656,519,53,53
412,0c293e50-dcb7-48b1-98d7-e63b96d51202,44127611,5262,450,35,415,0,52
412,0c293e50-dcb7-48b1-98d7-e63b96d51202,44127611,5262,491,463,28,1,52
412,0c293e50-dcb7-48b1-98d7-e63b96d51202,44127611,5262,1207,543,664,4,52
412,0c293e50-dcb7-48b1-98d7-e63b96d51202,44127611,5262,1565,1272,293,20,52
412,0c293e50-dcb7-48b1-98d7-e63b96d51202,44127611,5262,1802,1600,202,21,52
412,0c293e50-dcb7-48b1-98d7-e63b96d51202,44127611,5262,2367,1803,564,25,52
412,0c293e50-dcb7-48b1-98d7-e63b96d51202,44127611,5262,2445,2376,69,26,52
412,0c293e50-dcb7-48b1-98d7-e63b96d51202,44127611,5262,2812,2448,364,33,52
412,0c293e50-dcb7-48b1-98d7-e63b96d51202,44127611,5262,3076,2841,235,41,52
412,0c293e50-dcb7-48b1-98d7-e63b96d51202,44127611,5262,3243,3096,147,42,52
412,0c293e50-dcb7-48b1-98d7-e63b96d51202,44127611,5262,3737,3267,470,46,52
412,0c293e50-dcb7-48b1-98d7-e63b96d51202,44127611,5262,3738,3738,0,52,52
410,2957cea6-5c42-4094-8359-60727745f802,44133905,4554,358,6,352,0,53
410,2957cea6-5c42-4094-8359-60727745f802,44133905,4554,551,359,192,1,53
410,2957cea6-5c42-4094-8359-60727745f802,44133905,4554,761,562,199,6,53
410,2957cea6-5c42-4094-8359-60727745f802,44133905,4554,902,771,131,7,53
410,2957cea6-5c42-4094-8359-60727745f802,44133905,4554,1182,926,256,9,53
410,2957cea6-5c42-4094-8359-60727745f802,44133905,4554,1268,1190,78,10,53
410,2957cea6-5c42-4094-8359-60727745f802,44133905,4554,1281,1281,0,21,53
410,2957cea6-5c42-4094-8359-60727745f802,44133905,4554,1418,1327,91,22,53
410,2957cea6-5c42-4094-8359-60727745f802,44133905,4554,1455,1430,25,29,53
410,2957cea6-5c42-4094-8359-60727745f802,44133905,4554,1721,1538,183,30,53
410,2957cea6-5c42-4094-8359-60727745f802,44133905,4554,1853,1737,116,34,53
410,2957cea6-5c42-4094-8359-60727745f802,44133905,4554,2046,1856,190,35,53
410,2957cea6-5c42-4094-8359-60727745f802,44133905,4554,2325,2055,270,41,53
410,2957cea6-5c42-4094-8359-60727745f802,44133905,4554,2554,2336,218,42,53
410,2957cea6-5c42-4094-8359-60727745f802,44133905,4554,2668,2556,112,43,53
410,2957cea6-5c42-4094-8359-60727745f802,44133905,4554,2746,2676,70,50,53
410,2957cea6-5c42-4094-8359-60727745f802,44133905,4554,2755,2753,2,51,53
410,2957cea6-5c42-4094-8359-60727745f802,44133905,4554,2965,2770,195,52,53
410,2957cea6-5c42-4094-8359-60727745f802,44133905,4554,3033,2989,44,53,53
422,d96a3326-9a4a-4185-9f06-c694ef7057f1,44134910,8130,239,14,225,0,272
422,d96a3326-9a4a-4185-9f06-c694ef7057f1,44134910,8130,238,0,-238,1,272
422,d96a3326-9a4a-4185-9f06-c694ef7057f1,44134910,8130,174,0,-174,2,272
422,d96a3326-9a4a-4185-9f06-c694ef7057f1,44134910,8130,147,0,-147,5,272
422,d96a3326-9a4a-4185-9f06-c694ef7057f1,44134910,8130,53,6,47,12,272
422,d96a3326-9a4a-4185-9f06-c694ef7057f1,44134910,8130,433,55,378,13,272
422,d96a3326-9a4a-4185-9f06-c694ef7057f1,44134910,8130,529,434,95,14,272
422,d96a3326-9a4a-4185-9f06-c694ef7057f1,44134910,8130,588,531,57,15,272
422,d96a3326-9a4a-4185-9f06-c694ef7057f1,44134910,8130,665,592,73,16,272
422,d96a3326-9a4a-4185-9f06-c694ef7057f1,44134910,8130,1106,700,406,30,272
422,d96a3326-9a4a-4185-9f06-c694ef7057f1,44134910,8130,1168,1111,57,31,272
422,d96a3326-9a4a-4185-9f06-c694ef7057f1,44134910,8130,1373,1174,199,32,272
422,d96a3326-9a4a-4185-9f06-c694ef7057f1,44134910,8130,1457,1379,78,33,272
422,d96a3326-9a4a-4185-9f06-c694ef7057f1,44134910,8130,1511,1462,49,34,272
422,d96a3326-9a4a-4185-9f06-c694ef7057f1,44134910,8130,1601,1520,81,36,272
422,d96a3326-9a4a-4185-9f06-c694ef7057f1,44134910,8130,1605,1602,3,37,272
422,d96a3326-9a4a-4185-9f06-c694ef7057f1,44134910,920,0,0,0,45,272
422,d96a3326-9a4a-4185-9f06-c694ef7057f1,44134910,8130,579,8,571,136,272
422,d96a3326-9a4a-4185-9f06-c694ef7057f1,44134910,8130,1117,598,519,137,272
422,d96a3326-9a4a-4185-9f06-c694ef7057f1,44134910,8130,1403,1120,283,138,272
422,d96a3326-9a4a-4185-9f06-c694ef7057f1,44134910,8130,1701,1414,287,139,272
422,d96a3326-9a4a-4185-9f06-c694ef7057f1,44134910,8130,1751,1514,-237,140,272
422,d96a3326-9a4a-4185-9f06-c694ef7057f1,44134910,8130,1596,1512,84,141,272
422,d96a3326-9a4a-4185-9f06-c694ef7057f1,44134910,8130,1940,1618,322,142,272
422,d96a3326-9a4a-4185-9f06-c694ef7057f1,44134910,8130,2030,1940,90,152,272
422,d96a3326-9a4a-4185-9f06-c694ef7057f1,44134910,8130,2154,2033,121,153,272
422,d96a3326-9a4a-4185-9f06-c694ef7057f1,44134910,8130,2255,2156,99,155,272
422,d96a3326-9a4a-4185-9f06-c694ef7057f1,44134910,8130,2349,2258,91,156,272
422,d96a3326-9a4a-4185-9f06-c694ef7057f1,44134910,8130,2484,2352,132,157,272
422,d96a3326-9a4a-4185-9f06-c694ef7057f1,44134910,8130,2583,2485,98,167,272
422,d96a3326-9a4a-4185-9f06-c694ef7057f1,44134910,8130,2767,2594,173,168,272
422,d96a3326-9a4a-4185-9f06-c694ef7057f1,44134910,8130,2891,2769,122,169,272
422,d96a3326-9a4a-4185-9f06-c694ef7057f1,44134910,8130,2950,2900,50,170,272
422,d96a3326-9a4a-4185-9f06-c694ef7057f1,44134910,8130,3083,2958,125,171,272
422,d96a3326-9a4a-4185-9f06-c694ef7057f1,44134910,8130,3131,3086,45,172,272
422,d96a3326-9a4a-4185-9f06-c694ef7057f1,44134910,8130,3165,3132,33,173,272
422,d96a3326-9a4a-4185-9f06-c694ef7057f1,44134910,8130,3398,3169,229,187,272
422,d96a3326-9a4a-4185-9f06-c694ef7057f1,44134910,8130,3522,3404,118,188,272
422,d96a3326-9a4a-4185-9f06-c694ef7057f1,44134910,8130,3587,3529,58,189,272
422,d96a3326-9a4a-4185-9f06-c694ef7057f1,44134910,8130,3630,3588,42,192,272
422,d96a3326-9a4a-4185-9f06-c694ef7057f1,44134910,8130,3654,3633,21,193,272
422,d96a3326-9a4a-4185-9f06-c694ef7057f1,44134910,8130,3737,3655,82,194,272
422,d96a3326-9a4a-4185-9f06-c694ef7057f1,44134910,8130,3743,3738,5,195,272
422,d96a3326-9a4a-4185-9f06-c694ef7057f1,44134910,8130,3841,3745,96,198,272
422,d96a3326-9a4a-4185-9f06-c694ef7057f1,44134910,8130,3946,3847,99,199,272
422,d96a3326-9a4a-4185-9f06-c694ef7057f1,44134910,8130,3982,3951,31,200,272
422,d96a3326-9a4a-4185-9f06-c694ef7057f1,44134910,8130,4068,3984,84,203,272
422,d96a3326-9a4a-4185-9f06-c694ef7057f1,44134910,8130,4163,4070,93,204,272
422,d96a3326-9a4a-4185-9f06-c694ef7057f1,44134910,8130,4122,4116,-6,205,272
422,d96a3326-9a4a-4185-9f06-c694ef7057f1,44134910,8130,4270,4119,151,207,272
422,d96a3326-9a4a-4185-9f06-c694ef7057f1,44134910,8130,4340,4274,66,208,272
422,d96a3326-9a4a-4185-9f06-c694ef7057f1,44134910,8130,4460,4342,118,214,272
422,d96a3326-9a4a-4185-9f06-c694ef7057f1,44134910,8130,4597,4462,135,215,272
422,d96a3326-9a4a-4185-9f06-c694ef7057f1,44134910,8130,4623,4598,25,216,272
422,d96a3326-9a4a-4185-9f06-c694ef7057f1,44134910,8130,4648,4625,23,217,272
422,d96a3326-9a4a-4185-9f06-c694ef7057f1,44134910,8130,4870,4665,205,227,272
422,d96a3326-9a4a-4185-9f06-c694ef7057f1,44134910,8130,4904,4882,22,228,272
422,d96a3326-9a4a-4185-9f06-c694ef7057f1,44134910,8130,5163,4920,243,229,272
422,d96a3326-9a4a-4185-9f06-c694ef7057f1,44134910,8130,5259,5170,89,231,272
422,d96a3326-9a4a-4185-9f06-c694ef7057f1,44134910,8130,5357,5260,97,232,272
422,d96a3326-9a4a-4185-9f06-c694ef7057f1,44134910,8130,5476,5359,117,233,272
422,d96a3326-9a4a-4185-9f06-c694ef7057f1,44134910,8130,5668,5480,188,239,272
422,d96a3326-9a4a-4185-9f06-c694ef7057f1,44134910,8130,5748,5682,66,240,272
422,d96a3326-9a4a-4185-9f06-c694ef7057f1,44134910,8130,5962,5762,200,247,272
422,d96a3326-9a4a-4185-9f06-c694ef7057f1,44134910,8130,5998,5963,35,248,272
422,d96a3326-9a4a-4185-9f06-c694ef7057f1,44134910,8130,6175,6012,163,249,272
422,d96a3326-9a4a-4185-9f06-c694ef7057f1,44134910,8130,6227,6185,42,250,272
422,d96a3326-9a4a-4185-9f06-c694ef7057f1,44134910,8130,6444,6236,208,257,272
422,d96a3326-9a4a-4185-9f06-c694ef7057f1,44134910,8130,6552,6446,106,258,272
422,d96a3326-9a4a-4185-9f06-c694ef7057f1,44134910,8130,6596,6557,39,259,272
422,d96a3326-9a4a-4185-9f06-c694ef7057f1,44134910,8130,6694,6601,93,260,272
422,d96a3326-9a4a-4185-9f06-c694ef7057f1,44134910,8130,6862,6696,166,261,272
422,d96a3326-9a4a-4185-9f06-c694ef7057f1,44134910,8130,6972,6880,92,268,272
422,d96a3326-9a4a-4185-9f06-c694ef7057f1,44134910,8130,7012,6974,38,269,272
422,d96a3326-9a4a-4185-9f06-c694ef7057f1,44134910,8130,7013,7013,0,270,272
422,d96a3326-9a4a-4185-9f06-c694ef7057f1,44134910,8130,7155,7016,139,271,272
422,d96a3326-9a4a-4185-9f06-c694ef7057f1,44134910,8130,7210,7157,53,272,272
422,d96a3326-9a4a-4185-9f06-c694ef7057f1,44141603,3482,430,28,402,0,35
422,d96a3326-9a4a-4185-9f06-c694ef7057f1,44141603,3482,581,448,133,1,35
422,d96a3326-9a4a-4185-9f06-c694ef7057f1,44141603,3482,760,590,170,3,35
422,d96a3326-9a4a-4185-9f06-c694ef7057f1,44141603,3482,897,766,131,4,35
422,d96a3326-9a4a-4185-9f06-c694ef7057f1,44141603,3482,988,899,89,9,35
422,d96a3326-9a4a-4185-9f06-c694ef7057f1,44141603,3482,1226,995,231,10,35
422,d96a3326-9a4a-4185-9f06-c694ef7057f1,44141603,3482,1416,1234,182,11,35
422,d96a3326-9a4a-4185-9f06-c694ef7057f1,44141603,3482,1429,1417,12,12,35
422,d96a3326-9a4a-4185-9f06-c694ef7057f1,44141603,3482,1662,1442,220,16,35
422,d96a3326-9a4a-4185-9f06-c694ef7057f1,44141603,3482,1683,1666,17,17,35
422,d96a3326-9a4a-4185-9f06-c694ef7057f1,44141603,3482,1730,1693,37,18,35
422,d96a3326-9a4a-4185-9f06-c694ef7057f1,44141603,3482,1960,1740,220,19,35
422,d96a3326-9a4a-4185-9f06-c694ef7057f1,44141603,3482,2145,1966,179,21,35
422,d96a3326-9a4a-4185-9f06-c694ef7057f1,44141603,3482,2154,2146,8,22,35
422,d96a3326-9a4a-4185-9f06-c694ef7057f1,44141603,3482,2194,2162,32,29,35
422,d96a3326-9a4a-4185-9f06-c694ef7057f1,44141603,3482,2420,2199,221,30,35
422,d96a3326-9a4a-4185-9f06-c694ef7057f1,44141603,3482,2562,2422,140,35,35
422,d96a3326-9a4a-4185-9f06-c694ef7057f1,44136258,4222,82,19,63,0,86
422,d96a3326-9a4a-4185-9f06-c694ef7057f1,44136258,4222,518,96,422,1,86
422,d96a3326-9a4a-4185-9f06-c694ef7057f1,44136258,4222,552,521,31,2,86
422,d96a3326-9a4a-4185-9f06-c694ef7057f1,44136258,4222,681,554,127,3,86
422,d96a3326-9a4a-4185-9f06-c694ef7057f1,44136258,4222,696,683,13,5,86
422,d96a3326-9a4a-4185-9f06-c694ef7057f1,44136258,4222,841,701,140,6,86
422,d96a3326-9a4a-4185-9f06-c694ef7057f1,44136258,4222,929,842,87,7,86
422,d96a3326-9a4a-4185-9f06-c694ef7057f1,44136258,4222,956,932,24,8,86
422,d96a3326-9a4a-4185-9f06-c694ef7057f1,44136258,4222,1125,958,167,9,86
422,d96a3326-9a4a-4185-9f06-c694ef7057f1,44136258,4222,1124,1000,-124,12,86
422,d96a3326-9a4a-4185-9f06-c694ef7057f1,44136258,4222,991,716,-275,15,86
422,d96a3326-9a4a-4185-9f06-c694ef7057f1,44136258,4222,882,12,870,28,86
422,d96a3326-9a4a-4185-9f06-c694ef7057f1,44136258,4222,890,788,-102,29,86
422,d96a3326-9a4a-4185-9f06-c694ef7057f1,44136258,4222,843,789,54,30,86
422,d96a3326-9a4a-4185-9f06-c694ef7057f1,44136258,4222,1042,845,197,31,86
422,d96a3326-9a4a-4185-9f06-c694ef7057f1,44136258,4222,1106,1044,62,32,86
422,d96a3326-9a4a-4185-9f06-c694ef7057f1,44136258,4222,1177,1108,69,33,86
422,d96a3326-9a4a-4185-9f06-c694ef7057f1,44136258,4222,1258,1179,79,35,86
422,d96a3326-9a4a-4185-9f06-c694ef7057f1,44136258,4222,1355,1259,96,36,86
422,d96a3326-9a4a-4185-9f06-c694ef7057f1,44136258,4222,1417,1357,60,45,86
422,d96a3326-9a4a-4185-9f06-c694ef7057f1,44136258,4222,1476,1422,54,46,86
422,d96a3326-9a4a-4185-9f06-c694ef7057f1,44136258,4222,1470,1070,-400,50,86
422,d96a3326-9a4a-4185-9f06-c694ef7057f1,44136258,4222,1038,730,-308,51,86
422,d96a3326-9a4a-4185-9f06-c694ef7057f1,44136258,4222,699,490,-209,52,86
422,d96a3326-9a4a-4185-9f06-c694ef7057f1,44136258,4222,633,429,204,53,86
422,d96a3326-9a4a-4185-9f06-c694ef7057f1,44136258,4222,960,650,310,54,86
422,d96a3326-9a4a-4185-9f06-c694ef7057f1,44136258,4222,1256,986,270,55,86
422,d96a3326-9a4a-4185-9f06-c694ef7057f1,44136258,4222,1394,1257,137,57,86
422,d96a3326-9a4a-4185-9f06-c694ef7057f1,44136258,4222,1499,1398,101,58,86
422,d96a3326-9a4a-4185-9f06-c694ef7057f1,44136258,4222,1586,1516,70,60,86
422,d96a3326-9a4a-4185-9f06-c694ef7057f1,44136258,4222,1764,1593,171,61,86
422,d96a3326-9a4a-4185-9f06-c694ef7057f1,44136258,4222,1865,1767,98,64,86
422,d96a3326-9a4a-4185-9f06-c694ef7057f1,44136258,4222,1999,1873,126,65,86
422,d96a3326-9a4a-4185-9f06-c694ef7057f1,44136258,4222,2157,2001,156,66,86
422,d96a3326-9a4a-4185-9f06-c694ef7057f1,44136258,4222,2476,2171,305,67,86
422,d96a3326-9a4a-4185-9f06-c694ef7057f1,44136258,4222,2687,2494,193,74,86
422,d96a3326-9a4a-4185-9f06-c694ef7057f1,44136258,4222,3056,2723,333,75,86
422,d96a3326-9a4a-4185-9f06-c694ef7057f1,44136258,4222,3049,2996,-53,76,86
422,d96a3326-9a4a-4185-9f06-c694ef7057f1,44136258,4222,2995,2995,0,78,86
422,d96a3326-9a4a-4185-9f06-c694ef7057f1,44136258,4222,3105,2994,111,79,86
422,d96a3326-9a4a-4185-9f06-c694ef7057f1,44136258,4222,3182,3112,70,80,86
422,d96a3326-9a4a-4185-9f06-c694ef7057f1,44136258,4222,3285,3186,99,84,86
422,d96a3326-9a4a-4185-9f06-c694ef7057f1,44136258,4222,3296,3287,9,85,86
422,d96a3326-9a4a-4185-9f06-c694ef7057f1,44136258,4222,3302,3302,0,86,86
422,d96a3326-9a4a-4185-9f06-c694ef7057f1,44129386,4844,250,11,239,0,12
422,d96a3326-9a4a-4185-9f06-c694ef7057f1,44129386,4844,280,253,27,1,12
422,d96a3326-9a4a-4185-9f06-c694ef7057f1,44129386,4844,514,285,229,2,12
422,d96a3326-9a4a-4185-9f06-c694ef7057f1,44129386,4844,702,518,184,3,12
422,d96a3326-9a4a-4185-9f06-c694ef7057f1,44129386,4844,818,706,112,9,12
422,d96a3326-9a4a-4185-9f06-c694ef7057f1,44129386,4844,1088,832,256,10,12
422,d96a3326-9a4a-4185-9f06-c694ef7057f1,44129386,4844,1202,1098,104,11,12
422,d96a3326-9a4a-4185-9f06-c694ef7057f1,44129386,4844,1378,1210,168,12,12
422,d96a3326-9a4a-4185-9f06-c694ef7057f1,44139459,2914,147,7,140,0,33
422,d96a3326-9a4a-4185-9f06-c694ef7057f1,44139459,2914,196,148,48,1,33
422,d96a3326-9a4a-4185-9f06-c694ef7057f1,44139459,2914,349,201,148,2,33
422,d96a3326-9a4a-4185-9f06-c694ef7057f1,44139459,2914,492,356,136,3,33
422,d96a3326-9a4a-4185-9f06-c694ef7057f1,44139459,2914,666,494,172,4,33
422,d96a3326-9a4a-4185-9f06-c694ef7057f1,44139459,2914,793,676,117,5,33
422,d96a3326-9a4a-4185-9f06-c694ef7057f1,44139459,2914,799,794,5,6,33
422,d96a3326-9a4a-4185-9f06-c694ef7057f1,44139459,2914,858,801,57,7,33
422,d96a3326-9a4a-4185-9f06-c694ef7057f1,44139459,2914,1027,861,166,8,33
422,d96a3326-9a4a-4185-9f06-c694ef7057f1,44139459,2914,1056,1029,27,9,33
422,d96a3326-9a4a-4185-9f06-c694ef7057f1,44139459,2914,1176,1061,115,10,33
422,d96a3326-9a4a-4185-9f06-c694ef7057f1,44139459,2914,1331,1180,151,13,33
422,d96a3326-9a4a-4185-9f06-c694ef7057f1,44139459,2914,1352,1335,17,14,33
422,d96a3326-9a4a-4185-9f06-c694ef7057f1,44139459,2914,1491,1361,130,18,33
422,d96a3326-9a4a-4185-9f06-c694ef7057f1,44139459,2914,1508,1495,13,19,33
422,d96a3326-9a4a-4185-9f06-c694ef7057f1,44139459,2914,1811,1514,297,27,33
422,d96a3326-9a4a-4185-9f06-c694ef7057f1,44139459,2914,1849,1816,33,28,33
422,d96a3326-9a4a-4185-9f06-c694ef7057f1,44139459,2914,1933,1850,83,29,33
422,d96a3326-9a4a-4185-9f06-c694ef7057f1,44139459,2914,1934,1934,0,30,33
422,d96a3326-9a4a-4185-9f06-c694ef7057f1,44139459,2914,1994,1939,55,33,33
422,d96a3326-9a4a-4185-9f06-c694ef7057f1,44137354,9284,248,3,245,0,80
422,d96a3326-9a4a-4185-9f06-c694ef7057f1,44137354,9284,321,249,72,2,80
422,d96a3326-9a4a-4185-9f06-c694ef7057f1,44137354,9284,590,322,268,7,80
422,d96a3326-9a4a-4185-9f06-c694ef7057f1,44137354,9284,644,592,52,8,80
422,d96a3326-9a4a-4185-9f06-c694ef7057f1,44137354,9284,794,649,145,9,80
422,d96a3326-9a4a-4185-9f06-c694ef7057f1,44137354,9284,1086,808,278,10,80
422,d96a3326-9a4a-4185-9f06-c694ef7057f1,44137354,9284,1292,1096,196,22,80
422,d96a3326-9a4a-4185-9f06-c694ef7057f1,44137354,9284,1487,1293,194,23,80
422,d96a3326-9a4a-4185-9f06-c694ef7057f1,44137354,9284,1560,1491,69,24,80
422,d96a3326-9a4a-4185-9f06-c694ef7057f1,44137354,9284,1719,1564,155,45,80
422,d96a3326-9a4a-4185-9f06-c694ef7057f1,44137354,9284,1871,1721,150,46,80
422,d96a3326-9a4a-4185-9f06-c694ef7057f1,44137354,9284,1968,1875,93,47,80
422,d96a3326-9a4a-4185-9f06-c694ef7057f1,44137354,9284,2078,1970,108,48,80
422,d96a3326-9a4a-4185-9f06-c694ef7057f1,44137354,9284,2083,2078,5,49,80
422,d96a3326-9a4a-4185-9f06-c694ef7057f1,44137354,9284,2198,2084,114,50,80
422,d96a3326-9a4a-4185-9f06-c694ef7057f1,44137354,9284,2383,2211,172,51,80
422,d96a3326-9a4a-4185-9f06-c694ef7057f1,44137354,9284,2535,2389,146,52,80
422,d96a3326-9a4a-4185-9f06-c694ef7057f1,44137354,9284,2577,2539,38,53,80
422,d96a3326-9a4a-4185-9f06-c694ef7057f1,44137354,9284,2582,2578,4,56,80
422,d96a3326-9a4a-4185-9f06-c694ef7057f1,44137354,9284,2670,2588,82,58,80
422,d96a3326-9a4a-4185-9f06-c694ef7057f1,44137354,9284,2809,2675,134,59,80
422,d96a3326-9a4a-4185-9f06-c694ef7057f1,44137354,9284,2913,2816,97,60,80
422,d96a3326-9a4a-4185-9f06-c694ef7057f1,44137354,9284,3310,2918,392,65,80
422,d96a3326-9a4a-4185-9f06-c694ef7057f1,44137354,9284,3514,3314,200,67,80
422,d96a3326-9a4a-4185-9f06-c694ef7057f1,44137354,9284,3518,3516,2,68,80
422,d96a3326-9a4a-4185-9f06-c694ef7057f1,44137354,9284,3543,3520,23,69,80
422,d96a3326-9a4a-4185-9f06-c694ef7057f1,44137354,9284,3728,3547,181,73,80
422,d96a3326-9a4a-4185-9f06-c694ef7057f1,44137354,9284,3846,3733,113,74,80
422,d96a3326-9a4a-4185-9f06-c694ef7057f1,44137354,9284,4019,3848,171,77,80
422,d96a3326-9a4a-4185-9f06-c694ef7057f1,44137354,9284,4202,4023,179,78,80
422,d96a3326-9a4a-4185-9f06-c694ef7057f1,44137354,9284,4204,4203,1,79,80
422,d96a3326-9a4a-4185-9f06-c694ef7057f1,44137354,9284,4376,4215,161,80,80
422,d96a3326-9a4a-4185-9f06-c694ef7057f1,44083625,4720,354,27,327,0,43
422,d96a3326-9a4a-4185-9f06-c694ef7057f1,44083625,4720,380,360,20,1,43
422,d96a3326-9a4a-4185-9f06-c694ef7057f1,44083625,4720,499,382,117,2,43
422,d96a3326-9a4a-4185-9f06-c694ef7057f1,44083625,4720,672,503,169,3,43
422,d96a3326-9a4a-4185-9f06-c694ef7057f1,44083625,4720,728,680,48,4,43
422,d96a3326-9a4a-4185-9f06-c694ef7057f1,44083625,4720,902,743,159,8,43
422,d96a3326-9a4a-4185-9f06-c694ef7057f1,44083625,4720,964,910,54,12,43
422,d96a3326-9a4a-4185-9f06-c694ef7057f1,44083625,4720,1060,972,88,13,43
422,d96a3326-9a4a-4185-9f06-c694ef7057f1,44083625,4720,1324,1061,263,15,43
422,d96a3326-9a4a-4185-9f06-c694ef7057f1,44083625,4720,1488,1332,156,16,43
422,d96a3326-9a4a-4185-9f06-c694ef7057f1,44083625,4720,1581,1490,91,17,43
422,d96a3326-9a4a-4185-9f06-c694ef7057f1,44083625,4720,1817,1584,233,18,43
422,d96a3326-9a4a-4185-9f06-c694ef7057f1,44083625,4720,2023,1823,200,19,43
422,d96a3326-9a4a-4185-9f06-c694ef7057f1,44083625,4720,2118,2027,91,20,43
422,d96a3326-9a4a-4185-9f06-c694ef7057f1,44083625,4720,2343,2126,217,21,43
422,d96a3326-9a4a-4185-9f06-c694ef7057f1,44083625,4720,2498,2350,148,22,43
422,d96a3326-9a4a-4185-9f06-c694ef7057f1,44083625,4720,2557,2510,47,25,43
422,d96a3326-9a4a-4185-9f06-c694ef7057f1,44083625,4720,2705,2562,143,26,43
422,d96a3326-9a4a-4185-9f06-c694ef7057f1,44083625,4720,2781,2708,73,27,43
422,d96a3326-9a4a-4185-9f06-c694ef7057f1,44083625,4720,2810,2783,27,28,43
422,d96a3326-9a4a-4185-9f06-c694ef7057f1,44083625,4720,2949,2817,132,29,43
422,d96a3326-9a4a-4185-9f06-c694ef7057f1,44083625,4720,2982,2904,78,30,43
422,d96a3326-9a4a-4185-9f06-c694ef7057f1,44083625,4720,3001,2984,17,31,43
422,d96a3326-9a4a-4185-9f06-c694ef7057f1,44083625,4720,2990,2897,-93,32,43
422,d96a3326-9a4a-4185-9f06-c694ef7057f1,44083625,4720,2896,2887,-9,33,43
422,d96a3326-9a4a-4185-9f06-c694ef7057f1,44083625,4720,2906,2879,27,34,43
422,d96a3326-9a4a-4185-9f06-c694ef7057f1,44083625,4720,3038,2907,131,35,43
422,d96a3326-9a4a-4185-9f06-c694ef7057f1,44083625,4720,3050,3050,0,41,43
422,d96a3326-9a4a-4185-9f06-c694ef7057f1,44083625,4720,3281,3061,220,42,43
422,d96a3326-9a4a-4185-9f06-c694ef7057f1,44083625,4720,3381,3289,92,43,43
411,9a4d6651-639a-4f9c-b974-6130abd35ab6,44151239,2712,321,26,295,0,3
411,9a4d6651-639a-4f9c-b974-6130abd35ab6,44151239,2712,369,331,38,1,3
411,9a4d6651-639a-4f9c-b974-6130abd35ab6,44151239,2712,1264,373,891,2,3
411,9a4d6651-639a-4f9c-b974-6130abd35ab6,44151239,2712,1332,1302,30,3,3
412,bdff5baa-1f4b-4ef3-a1e5-9a1d4744fdf1,44143297,6102,604,22,582,0,79
412,bdff5baa-1f4b-4ef3-a1e5-9a1d4744fdf1,44143297,6102,736,626,110,10,79
412,bdff5baa-1f4b-4ef3-a1e5-9a1d4744fdf1,44143297,6102,1108,760,348,11,79
412,bdff5baa-1f4b-4ef3-a1e5-9a1d4744fdf1,44143297,6102,1624,1122,502,21,79
412,bdff5baa-1f4b-4ef3-a1e5-9a1d4744fdf1,44143297,6102,2270,1625,645,32,79
412,bdff5baa-1f4b-4ef3-a1e5-9a1d4744fdf1,44143297,6102,2850,2280,570,42,79
412,bdff5baa-1f4b-4ef3-a1e5-9a1d4744fdf1,44143297,6102,3366,2908,458,52,79
412,bdff5baa-1f4b-4ef3-a1e5-9a1d4744fdf1,44143297,6102,3355,3352,-3,53,79
412,bdff5baa-1f4b-4ef3-a1e5-9a1d4744fdf1,44143297,6102,3995,3359,636,65,79
412,bdff5baa-1f4b-4ef3-a1e5-9a1d4744fdf1,44143297,6102,4386,4000,386,71,79
412,bdff5baa-1f4b-4ef3-a1e5-9a1d4744fdf1,44143297,6102,4578,4400,178,79,79
412,bdff5baa-1f4b-4ef3-a1e5-9a1d4744fdf1,44139467,5142,515,27,488,0,63
412,bdff5baa-1f4b-4ef3-a1e5-9a1d4744fdf1,44139467,5142,1009,558,451,4,63
412,bdff5baa-1f4b-4ef3-a1e5-9a1d4744fdf1,44139467,5142,1449,1098,351,18,63
412,bdff5baa-1f4b-4ef3-a1e5-9a1d4744fdf1,44139467,5142,1450,1450,0,19,63
412,bdff5baa-1f4b-4ef3-a1e5-9a1d4744fdf1,44139467,5142,1820,1496,324,27,63
412,bdff5baa-1f4b-4ef3-a1e5-9a1d4744fdf1,44139467,5142,2494,1869,625,36,63
412,bdff5baa-1f4b-4ef3-a1e5-9a1d4744fdf1,44139467,5142,2971,2496,475,44,63
412,bdff5baa-1f4b-4ef3-a1e5-9a1d4744fdf1,44139467,5142,3296,3012,284,56,63
412,bdff5baa-1f4b-4ef3-a1e5-9a1d4744fdf1,44139467,5142,3351,3311,40,57,63
412,bdff5baa-1f4b-4ef3-a1e5-9a1d4744fdf1,44139467,5142,3587,3368,219,62,63
412,bdff5baa-1f4b-4ef3-a1e5-9a1d4744fdf1,44139467,5142,3618,3600,18,63,63
412,bdff5baa-1f4b-4ef3-a1e5-9a1d4744fdf1,44124546,4998,541,64,477,0,36
412,bdff5baa-1f4b-4ef3-a1e5-9a1d4744fdf1,44124546,4998,1206,572,634,12,36
412,bdff5baa-1f4b-4ef3-a1e5-9a1d4744fdf1,44124546,4998,2002,1246,756,15,36
412,bdff5baa-1f4b-4ef3-a1e5-9a1d4744fdf1,44124546,4998,2056,2013,43,16,36
412,bdff5baa-1f4b-4ef3-a1e5-9a1d4744fdf1,44124546,4998,2624,2079,545,22,36
412,bdff5baa-1f4b-4ef3-a1e5-9a1d4744fdf1,44124546,4998,3040,2686,354,30,36
412,bdff5baa-1f4b-4ef3-a1e5-9a1d4744fdf1,44124546,4998,3177,3058,119,31,36
412,bdff5baa-1f4b-4ef3-a1e5-9a1d4744fdf1,44124546,4998,3474,3282,192,36,36
422,9f63b3e0-83db-45ef-ba03-885d83274bcd,44151239,4698,289,18,271,0,75
422,9f63b3e0-83db-45ef-ba03-885d83274bcd,44151239,4698,514,305,209,1,75
422,9f63b3e0-83db-45ef-ba03-885d83274bcd,44151239,4698,584,516,68,2,75
422,9f63b3e0-83db-45ef-ba03-885d83274bcd,44151239,4698,721,589,132,5,75
422,9f63b3e0-83db-45ef-ba03-885d83274bcd,44151239,4698,887,728,159,6,75
422,9f63b3e0-83db-45ef-ba03-885d83274bcd,44151239,4698,1065,888,177,7,75
422,9f63b3e0-83db-45ef-ba03-885d83274bcd,44151239,4698,1067,607,-460,8,75
422,9f63b3e0-83db-45ef-ba03-885d83274bcd,44151239,4698,622,609,13,9,75
422,9f63b3e0-83db-45ef-ba03-885d83274bcd,44151239,4698,624,623,1,10,75
422,9f63b3e0-83db-45ef-ba03-885d83274bcd,44151239,4698,621,611,-10,11,75
422,9f63b3e0-83db-45ef-ba03-885d83274bcd,44151239,4698,653,616,37,19,75
422,9f63b3e0-83db-45ef-ba03-885d83274bcd,44151239,4698,1020,672,348,20,75
422,9f63b3e0-83db-45ef-ba03-885d83274bcd,44151239,4698,1244,1025,219,21,75
422,9f63b3e0-83db-45ef-ba03-885d83274bcd,44151239,4698,1539,1249,290,22,75
422,9f63b3e0-83db-45ef-ba03-885d83274bcd,44151239,4698,1627,1544,83,23,75
422,9f63b3e0-83db-45ef-ba03-885d83274bcd,44151239,4698,1717,1647,70,34,75
422,9f63b3e0-83db-45ef-ba03-885d83274bcd,44151239,4698,2041,1722,319,35,75
422,9f63b3e0-83db-45ef-ba03-885d83274bcd,44151239,4698,2000,1840,-160,36,75
422,9f63b3e0-83db-45ef-ba03-885d83274bcd,44151239,4698,2166,1900,266,37,75
422,9f63b3e0-83db-45ef-ba03-885d83274bcd,44151239,4698,2344,2166,178,38,75
422,9f63b3e0-83db-45ef-ba03-885d83274bcd,44151239,4698,2347,2297,-50,39,75
422,9f63b3e0-83db-45ef-ba03-885d83274bcd,44151239,4698,2315,2301,14,40,75
422,9f63b3e0-83db-45ef-ba03-885d83274bcd,44151239,4698,2304,1493,-811,42,75
422,9f63b3e0-83db-45ef-ba03-885d83274bcd,44151239,4698,1671,1490,181,43,75
422,9f63b3e0-83db-45ef-ba03-885d83274bcd,44151239,4698,1670,1564,-106,44,75
422,9f63b3e0-83db-45ef-ba03-885d83274bcd,44151239,4698,2196,1565,631,45,75
422,9f63b3e0-83db-45ef-ba03-885d83274bcd,44151239,4698,2207,2198,9,46,75
422,9f63b3e0-83db-45ef-ba03-885d83274bcd,44151239,4698,2409,2210,199,50,75
422,9f63b3e0-83db-45ef-ba03-885d83274bcd,44151239,4698,2457,2411,46,51,75
422,9f63b3e0-83db-45ef-ba03-885d83274bcd,44151239,4698,2685,2464,221,53,75
422,9f63b3e0-83db-45ef-ba03-885d83274bcd,44151239,4698,2663,2576,-87,54,75
422,9f63b3e0-83db-45ef-ba03-885d83274bcd,44151239,4698,2748,2580,168,55,75
422,9f63b3e0-83db-45ef-ba03-885d83274bcd,44151239,4698,2824,2758,66,56,75
422,9f63b3e0-83db-45ef-ba03-885d83274bcd,44151239,4698,3213,2833,380,69,75
422,9f63b3e0-83db-45ef-ba03-885d83274bcd,44151239,4698,3408,3221,187,72,75
422,9f63b3e0-83db-45ef-ba03-885d83274bcd,44151239,4698,3608,3413,195,73,75
422,9f63b3e0-83db-45ef-ba03-885d83274bcd,44151239,4698,3768,3616,152,74,75
422,9f63b3e0-83db-45ef-ba03-885d83274bcd,44151239,4698,3778,3770,8,75,75
422,9f63b3e0-83db-45ef-ba03-885d83274bcd,44148285,8880,388,5,383,0,46
422,9f63b3e0-83db-45ef-ba03-885d83274bcd,44148285,8880,540,398,142,1,46
422,9f63b3e0-83db-45ef-ba03-885d83274bcd,44148285,8880,637,543,94,2,46
422,9f63b3e0-83db-45ef-ba03-885d83274bcd,44148285,8880,714,638,76,9,46
422,9f63b3e0-83db-45ef-ba03-885d83274bcd,44148285,8880,828,715,113,10,46
422,9f63b3e0-83db-45ef-ba03-885d83274bcd,44148285,8880,885,829,56,11,46
422,9f63b3e0-83db-45ef-ba03-885d83274bcd,44148285,8880,988,887,101,12,46
422,9f63b3e0-83db-45ef-ba03-885d83274bcd,44148285,8880,1043,989,54,13,46
422,9f63b3e0-83db-45ef-ba03-885d83274bcd,44148285,8880,1049,1045,4,14,46
422,9f63b3e0-83db-45ef-ba03-885d83274bcd,44148285,8880,1207,1054,153,15,46
422,9f63b3e0-83db-45ef-ba03-885d83274bcd,44148285,8880,1209,1209,0,16,46
422,9f63b3e0-83db-45ef-ba03-885d83274bcd,44148285,8880,1228,1213,15,18,46
422,9f63b3e0-83db-45ef-ba03-885d83274bcd,44148285,8880,1421,1234,187,19,46
422,9f63b3e0-83db-45ef-ba03-885d83274bcd,44148285,8880,1478,1423,55,20,46
422,9f63b3e0-83db-45ef-ba03-885d83274bcd,44148285,8880,1715,1487,228,21,46
422,9f63b3e0-83db-45ef-ba03-885d83274bcd,44148285,8880,1817,1721,96,22,46
422,9f63b3e0-83db-45ef-ba03-885d83274bcd,44148285,8880,1822,1818,4,23,46
422,9f63b3e0-83db-45ef-ba03-885d83274bcd,44148285,8880,2100,1829,271,25,46
422,9f63b3e0-83db-45ef-ba03-885d83274bcd,44148285,8880,2291,2113,178,31,46
422,9f63b3e0-83db-45ef-ba03-885d83274bcd,44148285,8880,2707,2301,406,40,46
422,9f63b3e0-83db-45ef-ba03-885d83274bcd,44148285,8880,2984,2729,255,45,46
422,9f63b3e0-83db-45ef-ba03-885d83274bcd,44148285,8880,3185,3006,179,46,46
422,9f63b3e0-83db-45ef-ba03-885d83274bcd,44151302,968,48,11,37,0,0
424,f1cf662b-1fce-4de0-8ec8-b544b6d34df1,44129714,9207,186,3,183,0,235
424,f1cf662b-1fce-4de0-8ec8-b544b6d34df1,44129714,9207,241,0,-241,1,235
424,f1cf662b-1fce-4de0-8ec8-b544b6d34df1,44129714,9207,161,1,160,2,235
424,f1cf662b-1fce-4de0-8ec8-b544b6d34df1,44129714,9207,320,162,158,3,235
424,f1cf662b-1fce-4de0-8ec8-b544b6d34df1,44129714,9207,581,336,245,4,235
424,f1cf662b-1fce-4de0-8ec8-b544b6d34df1,44129714,9207,677,583,94,5,235
424,f1cf662b-1fce-4de0-8ec8-b544b6d34df1,44129714,9207,852,680,172,6,235
424,f1cf662b-1fce-4de0-8ec8-b544b6d34df1,44129714,9207,782,637,-145,47,235
424,f1cf662b-1fce-4de0-8ec8-b544b6d34df1,44129714,9207,557,0,-557,48,235
424,f1cf662b-1fce-4de0-8ec8-b544b6d34df1,44129714,9207,1371,4,1367,61,235
424,f1cf662b-1fce-4de0-8ec8-b544b6d34df1,44129714,9207,1487,1219,-268,62,235
424,f1cf662b-1fce-4de0-8ec8-b544b6d34df1,44129714,9207,1208,901,-307,70,235
424,f1cf662b-1fce-4de0-8ec8-b544b6d34df1,44129714,9207,900,886,-14,71,235
424,f1cf662b-1fce-4de0-8ec8-b544b6d34df1,44129714,9207,1089,889,200,72,235
424,f1cf662b-1fce-4de0-8ec8-b544b6d34df1,44129714,9207,1242,1101,141,97,235
424,f1cf662b-1fce-4de0-8ec8-b544b6d34df1,44129714,9207,1361,1246,115,142,235
424,f1cf662b-1fce-4de0-8ec8-b544b6d34df1,44129714,9207,1716,1371,345,144,235
424,f1cf662b-1fce-4de0-8ec8-b544b6d34df1,44129714,9207,1851,1739,112,145,235
424,f1cf662b-1fce-4de0-8ec8-b544b6d34df1,44129714,9207,1953,1859,94,146,235
424,f1cf662b-1fce-4de0-8ec8-b544b6d34df1,44129714,9207,2056,1956,100,157,235
424,f1cf662b-1fce-4de0-8ec8-b544b6d34df1,44129714,9207,2062,2057,5,158,235
424,f1cf662b-1fce-4de0-8ec8-b544b6d34df1,44129714,9207,2656,2088,568,190,235
424,f1cf662b-1fce-4de0-8ec8-b544b6d34df1,44129714,9207,2725,2667,58,191,235
424,f1cf662b-1fce-4de0-8ec8-b544b6d34df1,44129714,9207,3073,2732,341,204,235
424,f1cf662b-1fce-4de0-8ec8-b544b6d34df1,44129714,9207,3458,3075,383,206,235
424,f1cf662b-1fce-4de0-8ec8-b544b6d34df1,44129714,9207,3825,3498,327,207,235
424,f1cf662b-1fce-4de0-8ec8-b544b6d34df1,44129714,9207,4138,3827,311,216,235
424,f1cf662b-1fce-4de0-8ec8-b544b6d34df1,44129714,9207,4355,4140,215,217,235
424,f1cf662b-1fce-4de0-8ec8-b544b6d34df1,44129714,9207,4571,4370,201,223,235
424,f1cf662b-1fce-4de0-8ec8-b544b6d34df1,44129714,9207,4609,4572,37,224,235
424,f1cf662b-1fce-4de0-8ec8-b544b6d34df1,44129714,9207,5252,4618,634,233,235
424,f1cf662b-1fce-4de0-8ec8-b544b6d34df1,44129714,9207,6159,5300,859,234,235
424,f1cf662b-1fce-4de0-8ec8-b544b6d34df1,44129714,9207,7683,6259,1424,235,235
424,c9f62cc7-3786-45fb-9c53-b16d84053259,44154398,3792,201,0,-201,0,64
424,c9f62cc7-3786-45fb-9c53-b16d84053259,44154398,3792,504,18,486,1,64
424,c9f62cc7-3786-45fb-9c53-b16d84053259,44154398,3792,673,525,148,2,64
424,c9f62cc7-3786-45fb-9c53-b16d84053259,44154398,3792,808,675,133,3,64
424,c9f62cc7-3786-45fb-9c53-b16d84053259,44154398,3792,896,819,77,5,64
424,c9f62cc7-3786-45fb-9c53-b16d84053259,44154398,3792,989,901,88,6,64
424,c9f62cc7-3786-45fb-9c53-b16d84053259,44154398,3792,1001,292,-709,7,64
424,c9f62cc7-3786-45fb-9c53-b16d84053259,44154398,3792,355,269,86,8,64
424,c9f62cc7-3786-45fb-9c53-b16d84053259,44154398,3792,540,354,186,9,64
424,c9f62cc7-3786-45fb-9c53-b16d84053259,44154398,3792,617,557,60,10,64
424,c9f62cc7-3786-45fb-9c53-b16d84053259,44154398,3792,726,629,97,11,64
424,c9f62cc7-3786-45fb-9c53-b16d84053259,44154398,3792,939,733,206,12,64
424,c9f62cc7-3786-45fb-9c53-b16d84053259,44154398,3792,1008,943,65,13,64
424,c9f62cc7-3786-45fb-9c53-b16d84053259,44154398,3792,1308,1012,296,18,64
424,c9f62cc7-3786-45fb-9c53-b16d84053259,44154398,3792,1363,1312,51,21,64
424,c9f62cc7-3786-45fb-9c53-b16d84053259,44154398,3792,1454,1364,90,22,64
424,c9f62cc7-3786-45fb-9c53-b16d84053259,44154398,3792,1734,1463,271,24,64
424,c9f62cc7-3786-45fb-9c53-b16d84053259,44154398,3792,1966,1738,228,61,64
424,c9f62cc7-3786-45fb-9c53-b16d84053259,44154398,3792,2168,1968,200,62,64
424,c9f62cc7-3786-45fb-9c53-b16d84053259,44154398,3792,2245,2181,64,63,64
424,c9f62cc7-3786-45fb-9c53-b16d84053259,44154398,3792,2268,2246,22,64,64
424,c9f62cc7-3786-45fb-9c53-b16d84053259,44140844,4389,202,6,196,0,881
424,c9f62cc7-3786-45fb-9c53-b16d84053259,44140844,4389,371,201,170,1,881
424,c9f62cc7-3786-45fb-9c53-b16d84053259,44140844,4389,624,376,248,2,881
424,c9f62cc7-3786-45fb-9c53-b16d84053259,44140844,4389,723,633,90,3,881
424,c9f62cc7-3786-45fb-9c53-b16d84053259,44140844,4389,896,728,168,18,881
424,c9f62cc7-3786-45fb-9c53-b16d84053259,44140844,4389,1164,914,250,19,881
424,c9f62cc7-3786-45fb-9c53-b16d84053259,44140844,4389,1617,1218,399,40,881
424,c9f62cc7-3786-45fb-9c53-b16d84053259,44140844,1524,0,0,0,59,881
424,c9f62cc7-3786-45fb-9c53-b16d84053259,44140844,19944,94,15,79,66,881
424,c9f62cc7-3786-45fb-9c53-b16d84053259,44140844,19944,216,97,119,67,881
424,c9f62cc7-3786-45fb-9c53-b16d84053259,44140844,19944,254,217,37,68,881
424,c9f62cc7-3786-45fb-9c53-b16d84053259,44140844,25890,276,258,18,70,881
424,c9f62cc7-3786-45fb-9c53-b16d84053259,44140844,26724,369,282,87,71,881
424,c9f62cc7-3786-45fb-9c53-b16d84053259,44140844,26724,461,370,91,72,881
424,c9f62cc7-3786-45fb-9c53-b16d84053259,44140844,26724,798,481,317,74,881
424,c9f62cc7-3786-45fb-9c53-b16d84053259,44140844,27687,2015,805,1210,75,881
424,c9f62cc7-3786-45fb-9c53-b16d84053259,44140844,27687,2175,2029,146,76,881
424,c9f62cc7-3786-45fb-9c53-b16d84053259,44140844,29217,2312,2180,132,77,881
424,c9f62cc7-3786-45fb-9c53-b16d84053259,44140844,29775,2580,2319,261,109,881
424,c9f62cc7-3786-45fb-9c53-b16d84053259,44140844,29775,2636,2582,54,110,881
424,c9f62cc7-3786-45fb-9c53-b16d84053259,44140844,29775,2875,2637,238,145,881
424,c9f62cc7-3786-45fb-9c53-b16d84053259,44140844,29775,3040,2888,152,146,881
424,c9f62cc7-3786-45fb-9c53-b16d84053259,44140844,29775,3275,3261,14,758,881
424,c9f62cc7-3786-45fb-9c53-b16d84053259,44140844,29775,3256,2804,-452,759,881
424,c9f62cc7-3786-45fb-9c53-b16d84053259,44140844,29775,2792,2581,-211,762,881
424,c9f62cc7-3786-45fb-9c53-b16d84053259,44140844,29775,2572,2394,-178,763,881
424,c9f62cc7-3786-45fb-9c53-b16d84053259,44140844,29775,2585,2495,90,764,881
424,c9f62cc7-3786-45fb-9c53-b16d84053259,44140844,29775,2728,2589,139,765,881
424,c9f62cc7-3786-45fb-9c53-b16d84053259,44140844,29775,2830,2733,97,766,881
424,c9f62cc7-3786-45fb-9c53-b16d84053259,44140844,29775,2833,2831,2,767,881
424,c9f62cc7-3786-45fb-9c53-b16d84053259,44140844,29775,2918,2835,83,773,881
424,c9f62cc7-3786-45fb-9c53-b16d84053259,44140844,29775,3077,2931,146,774,881
424,c9f62cc7-3786-45fb-9c53-b16d84053259,44140844,29775,3098,3081,17,775,881
424,c9f62cc7-3786-45fb-9c53-b16d84053259,44140844,29775,3225,3114,111,776,881
424,c9f62cc7-3786-45fb-9c53-b16d84053259,44140844,29775,3513,3234,279,778,881
424,c9f62cc7-3786-45fb-9c53-b16d84053259,44140844,29775,3612,3522,90,780,881
424,c9f62cc7-3786-45fb-9c53-b16d84053259,44140844,29775,3641,3621,20,782,881
424,c9f62cc7-3786-45fb-9c53-b16d84053259,44140844,29775,3699,3647,52,783,881
424,c9f62cc7-3786-45fb-9c53-b16d84053259,44140844,29775,3704,3704,0,791,881
424,c9f62cc7-3786-45fb-9c53-b16d84053259,44140844,29775,3853,3717,136,792,881
424,c9f62cc7-3786-45fb-9c53-b16d84053259,44140844,29775,4118,3879,239,793,881
424,c9f62cc7-3786-45fb-9c53-b16d84053259,44140844,29775,4212,4129,83,794,881
424,c9f62cc7-3786-45fb-9c53-b16d84053259,44140844,29775,4318,4223,95,829,881
424,c9f62cc7-3786-45fb-9c53-b16d84053259,44140844,29775,4758,4338,420,830,881
424,c9f62cc7-3786-45fb-9c53-b16d84053259,44140844,29775,4783,4764,19,831,881
424,c9f62cc7-3786-45fb-9c53-b16d84053259,44140844,29775,5034,4831,203,870,881
424,c9f62cc7-3786-45fb-9c53-b16d84053259,44140844,29775,5175,5054,121,871,881
424,c9f62cc7-3786-45fb-9c53-b16d84053259,44140844,29775,5174,5174,0,872,881
424,c9f62cc7-3786-45fb-9c53-b16d84053259,44140844,29775,5857,5216,641,873,881
424,c9f62cc7-3786-45fb-9c53-b16d84053259,44140844,29775,5873,5861,12,874,881
424,c9f62cc7-3786-45fb-9c53-b16d84053259,44140844,29772,5929,5875,54,875,881
424,c9f62cc7-3786-45fb-9c53-b16d84053259,44140844,29772,6031,5936,95,876,881
424,c9f62cc7-3786-45fb-9c53-b16d84053259,44140844,29772,6505,6055,450,878,881
424,c9f62cc7-3786-45fb-9c53-b16d84053259,44140844,29772,6958,6540,418,879,881
424,c9f62cc7-3786-45fb-9c53-b16d84053259,44140844,29772,8240,6991,1249,880,881
424,c9f62cc7-3786-45fb-9c53-b16d84053259,44140844,29772,8255,8244,11,881,881
423,30d21da7-b4b6-49d1-a82e-01f3564ba99d,44158566,7596,131,16,115,0,137
423,30d21da7-b4b6-49d1-a82e-01f3564ba99d,44158566,7596,403,154,249,1,137
423,30d21da7-b4b6-49d1-a82e-01f3564ba99d,44158566,7596,638,416,222,6,137
423,30d21da7-b4b6-49d1-a82e-01f3564ba99d,44158566,7596,847,657,190,11,137
423,30d21da7-b4b6-49d1-a82e-01f3564ba99d,44158566,7596,1041,848,193,15,137
423,30d21da7-b4b6-49d1-a82e-01f3564ba99d,44158566,7596,1156,1049,107,24,137
423,30d21da7-b4b6-49d1-a82e-01f3564ba99d,44158566,7596,1236,1165,71,25,137
423,30d21da7-b4b6-49d1-a82e-01f3564ba99d,44158566,7596,1553,1261,292,28,137
423,30d21da7-b4b6-49d1-a82e-01f3564ba99d,44158566,7596,1736,1577,159,29,137
423,30d21da7-b4b6-49d1-a82e-01f3564ba99d,44158566,7596,1886,1742,144,38,137
423,30d21da7-b4b6-49d1-a82e-01f3564ba99d,44158566,7596,1921,1900,21,39,137
423,30d21da7-b4b6-49d1-a82e-01f3564ba99d,44158566,7596,1995,1925,70,42,137
423,30d21da7-b4b6-49d1-a82e-01f3564ba99d,44158566,7596,1955,1798,-157,45,137
423,30d21da7-b4b6-49d1-a82e-01f3564ba99d,44158566,7596,1972,1818,154,46,137
423,30d21da7-b4b6-49d1-a82e-01f3564ba99d,44158566,7596,2141,1981,160,53,137
423,30d21da7-b4b6-49d1-a82e-01f3564ba99d,44158566,7596,2142,2136,-6,54,137
423,30d21da7-b4b6-49d1-a82e-01f3564ba99d,44158566,7596,2319,2141,178,66,137
423,30d21da7-b4b6-49d1-a82e-01f3564ba99d,44158566,7596,2450,2343,107,68,137
423,30d21da7-b4b6-49d1-a82e-01f3564ba99d,44158566,7596,2459,2456,3,69,137
423,30d21da7-b4b6-49d1-a82e-01f3564ba99d,44158566,7596,2643,2462,181,76,137
423,30d21da7-b4b6-49d1-a82e-01f3564ba99d,44158566,7596,2708,2652,56,77,137
423,30d21da7-b4b6-49d1-a82e-01f3564ba99d,44158566,7596,2745,2725,20,78,137
423,30d21da7-b4b6-49d1-a82e-01f3564ba99d,44158566,7596,2960,2754,206,80,137
423,30d21da7-b4b6-49d1-a82e-01f3564ba99d,44158566,7596,3028,2961,67,81,137
423,30d21da7-b4b6-49d1-a82e-01f3564ba99d,44158566,7596,3042,3031,11,88,137
423,30d21da7-b4b6-49d1-a82e-01f3564ba99d,44158566,7596,3258,3052,206,89,137
423,30d21da7-b4b6-49d1-a82e-01f3564ba99d,44158566,7596,3535,3276,259,100,137
423,30d21da7-b4b6-49d1-a82e-01f3564ba99d,44158566,7596,3684,3541,143,108,137
423,30d21da7-b4b6-49d1-a82e-01f3564ba99d,44158566,7596,3853,3697,156,109,137
423,30d21da7-b4b6-49d1-a82e-01f3564ba99d,44158566,7596,3982,3855,127,119,137
423,30d21da7-b4b6-49d1-a82e-01f3564ba99d,44158566,7596,4144,3999,145,120,137
423,30d21da7-b4b6-49d1-a82e-01f3564ba99d,44158566,7596,4320,4162,158,121,137
423,30d21da7-b4b6-49d1-a82e-01f3564ba99d,44158566,7596,4324,4321,-3,122,137
423,30d21da7-b4b6-49d1-a82e-01f3564ba99d,44158566,7596,4394,4332,62,125,137
423,30d21da7-b4b6-49d1-a82e-01f3564ba99d,44158566,7596,4580,4400,180,131,137
423,30d21da7-b4b6-49d1-a82e-01f3564ba99d,44158566,7596,4749,4584,165,134,137
423,30d21da7-b4b6-49d1-a82e-01f3564ba99d,44158566,7596,4827,4756,71,137,137
423,30d21da7-b4b6-49d1-a82e-01f3564ba99d,44148027,6958,112,9,103,0,103
423,30d21da7-b4b6-49d1-a82e-01f3564ba99d,44148027,6958,169,128,41,1,103
423,30d21da7-b4b6-49d1-a82e-01f3564ba99d,44148027,6958,147,0,-147,2,103
423,30d21da7-b4b6-49d1-a82e-01f3564ba99d,44148027,6958,105,4,101,3,103
423,30d21da7-b4b6-49d1-a82e-01f3564ba99d,44148027,6958,254,117,137,4,103
423,30d21da7-b4b6-49d1-a82e-01f3564ba99d,44148027,6958,496,261,235,12,103
423,30d21da7-b4b6-49d1-a82e-01f3564ba99d,44148027,6958,630,499,131,13,103
423,30d21da7-b4b6-49d1-a82e-01f3564ba99d,44148027,6958,859,670,189,14,103
423,30d21da7-b4b6-49d1-a82e-01f3564ba99d,44148027,6958,985,874,111,15,103
423,30d21da7-b4b6-49d1-a82e-01f3564ba99d,44148027,6958,1045,995,50,23,103
423,30d21da7-b4b6-49d1-a82e-01f3564ba99d,44148027,6958,1129,1060,69,24,103
423,30d21da7-b4b6-49d1-a82e-01f3564ba99d,44148027,6958,1347,1140,207,25,103
423,30d21da7-b4b6-49d1-a82e-01f3564ba99d,44148027,6958,1519,1354,165,31,103
423,30d21da7-b4b6-49d1-a82e-01f3564ba99d,44148027,6958,1618,1521,97,32,103
423,30d21da7-b4b6-49d1-a82e-01f3564ba99d,44148027,6958,1729,1634,95,33,103
423,30d21da7-b4b6-49d1-a82e-01f3564ba99d,44148027,6958,1880,1739,141,35,103
423,30d21da7-b4b6-49d1-a82e-01f3564ba99d,44148027,6958,2027,1888,139,37,103
423,30d21da7-b4b6-49d1-a82e-01f3564ba99d,44148027,6958,2162,2032,130,47,103
423,30d21da7-b4b6-49d1-a82e-01f3564ba99d,44148027,6958,2479,2163,316,51,103
423,30d21da7-b4b6-49d1-a82e-01f3564ba99d,44148027,6958,2621,2484,137,52,103
423,30d21da7-b4b6-49d1-a82e-01f3564ba99d,44148027,6958,2866,2632,234,54,103
423,30d21da7-b4b6-49d1-a82e-01f3564ba99d,44148027,6958,2936,2867,69,55,103
423,30d21da7-b4b6-49d1-a82e-01f3564ba99d,44148027,6958,3033,2942,91,58,103
423,30d21da7-b4b6-49d1-a82e-01f3564ba99d,44148027,6958,3089,3044,45,59,103
423,30d21da7-b4b6-49d1-a82e-01f3564ba99d,44148027,6958,3312,3102,210,63,103
423,30d21da7-b4b6-49d1-a82e-01f3564ba99d,44148027,6958,3315,3314,1,64,103
423,30d21da7-b4b6-49d1-a82e-01f3564ba99d,44148027,6958,3390,3321,69,66,103
423,30d21da7-b4b6-49d1-a82e-01f3564ba99d,44148027,6958,3487,3398,89,67,103
423,30d21da7-b4b6-49d1-a82e-01f3564ba99d,44148027,6958,3608,3493,115,69,103
423,30d21da7-b4b6-49d1-a82e-01f3564ba99d,44148027,6958,3689,3611,78,70,103
423,30d21da7-b4b6-49d1-a82e-01f3564ba99d,44148027,6958,3693,3690,3,71,103
423,30d21da7-b4b6-49d1-a82e-01f3564ba99d,44148027,6958,4010,3706,304,95,103
423,30d21da7-b4b6-49d1-a82e-01f3564ba99d,44148027,6958,4278,4047,231,96,103
423,30d21da7-b4b6-49d1-a82e-01f3564ba99d,44148027,6958,4419,4283,136,98,103
423,30d21da7-b4b6-49d1-a82e-01f3564ba99d,44148027,6958,4723,4423,300,99,103
423,30d21da7-b4b6-49d1-a82e-01f3564ba99d,44148027,6958,4724,4724,0,100,103
423,30d21da7-b4b6-49d1-a82e-01f3564ba99d,44148027,6958,5111,4731,380,102,103
423,30d21da7-b4b6-49d1-a82e-01f3564ba99d,44148027,6958,5211,5148,63,103,103
411,642b557c-a5c2-4aa9-b90a-92f18c688606,44163575,8595,76,3,73,0,164
411,642b557c-a5c2-4aa9-b90a-92f18c688606,44163575,8595,492,91,401,1,164
411,642b557c-a5c2-4aa9-b90a-92f18c688606,44163575,8595,666,496,170,2,164
411,642b557c-a5c2-4aa9-b90a-92f18c688606,44163575,8595,901,670,231,3,164
411,642b557c-a5c2-4aa9-b90a-92f18c688606,44163575,8595,960,902,58,15,164
411,642b557c-a5c2-4aa9-b90a-92f18c688606,44163575,8595,1154,971,183,25,164
411,642b557c-a5c2-4aa9-b90a-92f18c688606,44163575,8595,1209,1159,50,26,164
411,642b557c-a5c2-4aa9-b90a-92f18c688606,44163575,8595,1428,1211,217,28,164
411,642b557c-a5c2-4aa9-b90a-92f18c688606,44163575,8595,1435,1432,3,29,164
411,642b557c-a5c2-4aa9-b90a-92f18c688606,44163575,8595,1508,1444,64,33,164
411,642b557c-a5c2-4aa9-b90a-92f18c688606,44163575,8595,1761,1510,251,35,164
411,642b557c-a5c2-4aa9-b90a-92f18c688606,44163575,8595,2139,1763,376,36,164
411,642b557c-a5c2-4aa9-b90a-92f18c688606,44163575,8595,2652,2148,504,37,164
411,642b557c-a5c2-4aa9-b90a-92f18c688606,44163575,8595,2817,2666,151,61,164
411,642b557c-a5c2-4aa9-b90a-92f18c688606,44163575,8595,3245,2818,427,62,164
411,642b557c-a5c2-4aa9-b90a-92f18c688606,44163575,8595,3523,3250,273,63,164
411,642b557c-a5c2-4aa9-b90a-92f18c688606,44163575,8595,3815,3532,283,80,164
411,642b557c-a5c2-4aa9-b90a-92f18c688606,44163575,8595,4111,3823,288,81,164
411,642b557c-a5c2-4aa9-b90a-92f18c688606,44163575,8595,4332,4112,220,104,164
411,642b557c-a5c2-4aa9-b90a-92f18c688606,44163575,8595,4369,4340,29,105,164
411,642b557c-a5c2-4aa9-b90a-92f18c688606,44163575,8595,4547,4378,169,107,164
411,642b557c-a5c2-4aa9-b90a-92f18c688606,44163575,8595,4787,4548,239,109,164
411,642b557c-a5c2-4aa9-b90a-92f18c688606,44163575,8595,5584,4811,773,119,164
411,642b557c-a5c2-4aa9-b90a-92f18c688606,44163575,8595,5658,5604,54,143,164
411,642b557c-a5c2-4aa9-b90a-92f18c688606,44163575,8595,6103,5683,420,144,164
411,642b557c-a5c2-4aa9-b90a-92f18c688606,44163575,8595,6214,6107,107,145,164
411,642b557c-a5c2-4aa9-b90a-92f18c688606,44163575,8595,7089,6243,846,146,164
411,642b557c-a5c2-4aa9-b90a-92f18c688606,44163575,8595,7215,6166,-1049,147,164
411,642b557c-a5c2-4aa9-b90a-92f18c688606,44163575,8595,6136,5078,-1058,148,164
411,642b557c-a5c2-4aa9-b90a-92f18c688606,44163575,8595,5058,4525,-533,149,164
411,642b557c-a5c2-4aa9-b90a-92f18c688606,44163575,8595,4506,4254,-252,150,164
411,642b557c-a5c2-4aa9-b90a-92f18c688606,44163575,8595,4720,4058,662,151,164
411,642b557c-a5c2-4aa9-b90a-92f18c688606,44163575,8595,5403,4753,650,152,164
411,642b557c-a5c2-4aa9-b90a-92f18c688606,44163575,27081,547,4,543,162,164
411,642b557c-a5c2-4aa9-b90a-92f18c688606,44163575,27081,1934,581,1353,163,164
411,642b557c-a5c2-4aa9-b90a-92f18c688606,44163575,27081,3165,1966,1199,164,164
411,642b557c-a5c2-4aa9-b90a-92f18c688606,44163141,7458,203,8,195,0,43
411,642b557c-a5c2-4aa9-b90a-92f18c688606,44163141,7458,761,243,518,1,43
411,642b557c-a5c2-4aa9-b90a-92f18c688606,44163141,7458,844,768,76,2,43
411,642b557c-a5c2-4aa9-b90a-92f18c688606,44163141,7458,905,849,56,3,43
411,642b557c-a5c2-4aa9-b90a-92f18c688606,44163141,7458,964,907,57,4,43
411,642b557c-a5c2-4aa9-b90a-92f18c688606,44163141,7458,1084,971,113,5,43
411,642b557c-a5c2-4aa9-b90a-92f18c688606,44163141,7458,1236,1094,142,8,43
411,642b557c-a5c2-4aa9-b90a-92f18c688606,44163141,7458,1305,1244,61,33,43
411,642b557c-a5c2-4aa9-b90a-92f18c688606,44163141,7458,1665,1313,352,34,43
411,642b557c-a5c2-4aa9-b90a-92f18c688606,44163141,7458,1785,1668,117,35,43
411,642b557c-a5c2-4aa9-b90a-92f18c688606,44163141,7458,1876,1790,86,36,43
411,642b557c-a5c2-4aa9-b90a-92f18c688606,44163141,7458,1886,1879,7,37,43
411,642b557c-a5c2-4aa9-b90a-92f18c688606,44163141,7458,1911,1889,22,38,43
411,642b557c-a5c2-4aa9-b90a-92f18c688606,44163141,7458,1924,1912,12,39,43
411,642b557c-a5c2-4aa9-b90a-92f18c688606,44163141,7458,1958,1925,33,40,43
411,642b557c-a5c2-4aa9-b90a-92f18c688606,44163141,7458,2243,1968,275,41,43
411,642b557c-a5c2-4aa9-b90a-92f18c688606,44163141,7458,2497,2246,251,42,43
411,642b557c-a5c2-4aa9-b90a-92f18c688606,44163141,7458,2628,2517,111,43,43
411,642b557c-a5c2-4aa9-b90a-92f18c688606,44152243,7095,326,26,300,0,24
411,642b557c-a5c2-4aa9-b90a-92f18c688606,44152243,7095,495,329,166,1,24
411,642b557c-a5c2-4aa9-b90a-92f18c688606,44152243,7095,581,496,85,7,24
411,642b557c-a5c2-4aa9-b90a-92f18c688606,44152243,7095,632,589,43,8,24
411,642b557c-a5c2-4aa9-b90a-92f18c688606,44152243,7095,743,638,105,9,24
411,642b557c-a5c2-4aa9-b90a-92f18c688606,44152243,7095,840,751,89,10,24
411,642b557c-a5c2-4aa9-b90a-92f18c688606,44152243,7095,1148,849,299,14,24
411,642b557c-a5c2-4aa9-b90a-92f18c688606,44152243,7095,1329,1154,175,16,24
411,642b557c-a5c2-4aa9-b90a-92f18c688606,44152243,7095,1873,1337,536,19,24
411,642b557c-a5c2-4aa9-b90a-92f18c688606,44152243,7095,2558,1881,677,20,24
411,642b557c-a5c2-4aa9-b90a-92f18c688606,44152243,7095,3246,2595,651,21,24
411,642b557c-a5c2-4aa9-b90a-92f18c688606,44152243,7095,4351,3279,1072,22,24
411,642b557c-a5c2-4aa9-b90a-92f18c688606,44152243,7095,4686,4357,329,23,24
411,642b557c-a5c2-4aa9-b90a-92f18c688606,44152243,7095,5715,4750,965,24,24
411,642b557c-a5c2-4aa9-b90a-92f18c688606,44143300,6939,153,1,152,0,32
411,642b557c-a5c2-4aa9-b90a-92f18c688606,44143300,6939,308,159,149,1,32
411,642b557c-a5c2-4aa9-b90a-92f18c688606,44143300,6939,320,312,8,2,32
411,642b557c-a5c2-4aa9-b90a-92f18c688606,44143300,6939,673,326,347,3,32
411,642b557c-a5c2-4aa9-b90a-92f18c688606,44143300,6939,841,681,160,4,32
411,642b557c-a5c2-4aa9-b90a-92f18c688606,44143300,6939,1138,842,296,5,32
411,642b557c-a5c2-4aa9-b90a-92f18c688606,44143300,6939,1178,1146,32,6,32
411,642b557c-a5c2-4aa9-b90a-92f18c688606,44143300,6939,1751,1188,563,8,32
411,642b557c-a5c2-4aa9-b90a-92f18c688606,44143300,6939,1875,1769,106,9,32
411,642b557c-a5c2-4aa9-b90a-92f18c688606,44143300,6939,2074,1885,189,11,32
411,642b557c-a5c2-4aa9-b90a-92f18c688606,44143300,6939,2198,2079,119,16,32
411,642b557c-a5c2-4aa9-b90a-92f18c688606,44143300,6939,2414,2203,211,17,32
411,642b557c-a5c2-4aa9-b90a-92f18c688606,44143300,6939,2472,2420,52,18,32
411,642b557c-a5c2-4aa9-b90a-92f18c688606,44143300,6939,2600,2481,119,19,32
411,642b557c-a5c2-4aa9-b90a-92f18c688606,44143300,6939,2741,2602,139,20,32
411,642b557c-a5c2-4aa9-b90a-92f18c688606,44143300,6939,2984,2751,233,21,32
411,642b557c-a5c2-4aa9-b90a-92f18c688606,44143300,6939,3037,2985,52,22,32
411,642b557c-a5c2-4aa9-b90a-92f18c688606,44143300,6939,3159,3038,121,23,32
411,642b557c-a5c2-4aa9-b90a-92f18c688606,44143300,6939,3210,3167,43,24,32
411,642b557c-a5c2-4aa9-b90a-92f18c688606,44143300,6939,3384,3217,167,26,32
411,642b557c-a5c2-4aa9-b90a-92f18c688606,44143300,6939,3695,3389,306,27,32
411,642b557c-a5c2-4aa9-b90a-92f18c688606,44143300,6939,3727,3702,25,28,32
411,642b557c-a5c2-4aa9-b90a-92f18c688606,44143300,6939,3730,3729,1,29,32
411,642b557c-a5c2-4aa9-b90a-92f18c688606,44143300,6939,3769,3733,36,30,32
411,642b557c-a5c2-4aa9-b90a-92f18c688606,44143300,6939,3853,3786,67,31,32
411,642b557c-a5c2-4aa9-b90a-92f18c688606,44143300,6939,4044,3859,185,32,32
412,8fe9e770-5e01-477c-9c5a-2d3bf622930c,44168094,4407,512,60,452,0,49
412,8fe9e770-5e01-477c-9c5a-2d3bf622930c,44168094,4407,561,515,46,1,49
412,8fe9e770-5e01-477c-9c5a-2d3bf622930c,44168094,4407,925,595,330,10,49
412,8fe9e770-5e01-477c-9c5a-2d3bf622930c,44168094,4407,1532,953,579,16,49
412,8fe9e770-5e01-477c-9c5a-2d3bf622930c,44168094,4407,1964,1534,430,26,49
412,8fe9e770-5e01-477c-9c5a-2d3bf622930c,44168094,4407,2345,1997,348,31,49
412,8fe9e770-5e01-477c-9c5a-2d3bf622930c,44168094,4407,2652,2349,303,37,49
412,8fe9e770-5e01-477c-9c5a-2d3bf622930c,44168094,4407,2883,2661,222,49,49
412,8fe9e770-5e01-477c-9c5a-2d3bf622930c,44168300,4227,329,35,294,0,14
412,8fe9e770-5e01-477c-9c5a-2d3bf622930c,44168300,4227,345,332,13,1,14
412,8fe9e770-5e01-477c-9c5a-2d3bf622930c,44168300,4227,867,348,519,10,14
412,8fe9e770-5e01-477c-9c5a-2d3bf622930c,44168300,4227,1072,895,177,11,14
412,8fe9e770-5e01-477c-9c5a-2d3bf622930c,44168300,4227,1575,1088,487,12,14
412,8fe9e770-5e01-477c-9c5a-2d3bf622930c,44168300,4227,2007,1598,409,13,14
412,8fe9e770-5e01-477c-9c5a-2d3bf622930c,44168300,4227,2348,2055,293,14,14
424,fdf277d4-7457-4b0f-a9b7-b4b9a0132f6f,44167000,3135,385,3,382,0,181
424,fdf277d4-7457-4b0f-a9b7-b4b9a0132f6f,44167000,3135,749,410,339,1,181
424,fdf277d4-7457-4b0f-a9b7-b4b9a0132f6f,44167000,3135,907,764,143,44,181
424,fdf277d4-7457-4b0f-a9b7-b4b9a0132f6f,44167000,3135,913,913,0,134,181
424,fdf277d4-7457-4b0f-a9b7-b4b9a0132f6f,44167000,3135,1085,931,154,135,181
424,fdf277d4-7457-4b0f-a9b7-b4b9a0132f6f,44167000,3135,1460,1095,365,144,181
424,fdf277d4-7457-4b0f-a9b7-b4b9a0132f6f,44167000,3135,1545,1471,74,145,181
424,fdf277d4-7457-4b0f-a9b7-b4b9a0132f6f,44167000,3135,1611,1554,57,181,181
424,fdf277d4-7457-4b0f-a9b7-b4b9a0132f6f,44164430,9837,192,9,183,0,80
424,fdf277d4-7457-4b0f-a9b7-b4b9a0132f6f,44164430,9837,477,0,-477,1,80
424,fdf277d4-7457-4b0f-a9b7-b4b9a0132f6f,44164430,9837,304,8,296,11,80
424,fdf277d4-7457-4b0f-a9b7-b4b9a0132f6f,44164430,9837,969,317,652,12,80
424,fdf277d4-7457-4b0f-a9b7-b4b9a0132f6f,44164430,9837,1403,978,425,54,80
424,fdf277d4-7457-4b0f-a9b7-b4b9a0132f6f,44164430,9837,1338,912,-426,55,80
424,fdf277d4-7457-4b0f-a9b7-b4b9a0132f6f,44164430,9837,1140,922,218,77,80
424,fdf277d4-7457-4b0f-a9b7-b4b9a0132f6f,44164430,9837,1830,1141,689,78,80
424,fdf277d4-7457-4b0f-a9b7-b4b9a0132f6f,44164430,9837,3998,1880,2118,79,80
424,fdf277d4-7457-4b0f-a9b7-b4b9a0132f6f,44164430,9837,4277,4023,254,80,80
424,fdf277d4-7457-4b0f-a9b7-b4b9a0132f6f,44153044,5451,284,7,277,0,43
424,fdf277d4-7457-4b0f-a9b7-b4b9a0132f6f,44153044,5451,879,308,571,1,43
424,fdf277d4-7457-4b0f-a9b7-b4b9a0132f6f,44153044,5451,861,747,-114,22,43
424,fdf277d4-7457-4b0f-a9b7-b4b9a0132f6f,44153044,5451,738,535,-203,23,43
424,fdf277d4-7457-4b0f-a9b7-b4b9a0132f6f,44153044,5451,706,534,172,24,43
424,fdf277d4-7457-4b0f-a9b7-b4b9a0132f6f,44153044,5451,1131,739,392,25,43
424,fdf277d4-7457-4b0f-a9b7-b4b9a0132f6f,44153044,5451,1327,1134,193,26,43
424,fdf277d4-7457-4b0f-a9b7-b4b9a0132f6f,44153044,5451,1554,1349,205,27,43
424,fdf277d4-7457-4b0f-a9b7-b4b9a0132f6f,44153044,5451,1786,1566,220,28,43
424,fdf277d4-7457-4b0f-a9b7-b4b9a0132f6f,44153044,5451,2002,1815,187,29,43
424,fdf277d4-7457-4b0f-a9b7-b4b9a0132f6f,44153044,5451,2366,2017,349,36,43
424,fdf277d4-7457-4b0f-a9b7-b4b9a0132f6f,44153044,5451,2652,2375,277,37,43
424,fdf277d4-7457-4b0f-a9b7-b4b9a0132f6f,44153044,5451,3289,2655,634,38,43
424,fdf277d4-7457-4b0f-a9b7-b4b9a0132f6f,44153044,5451,3528,3290,238,39,43
424,fdf277d4-7457-4b0f-a9b7-b4b9a0132f6f,44153044,5451,3529,3529,0,40,43
424,fdf277d4-7457-4b0f-a9b7-b4b9a0132f6f,44153044,5451,3881,3600,281,43,43
424,fdf277d4-7457-4b0f-a9b7-b4b9a0132f6f,44141840,7032,235,10,225,0,262
424,fdf277d4-7457-4b0f-a9b7-b4b9a0132f6f,44141840,7032,781,273,508,1,262
424,fdf277d4-7457-4b0f-a9b7-b4b9a0132f6f,44141840,7032,963,791,172,2,262
424,fdf277d4-7457-4b0f-a9b7-b4b9a0132f6f,44141840,7032,1204,969,235,19,262
424,fdf277d4-7457-4b0f-a9b7-b4b9a0132f6f,44141840,7032,1320,1220,100,20,262
424,fdf277d4-7457-4b0f-a9b7-b4b9a0132f6f,44141840,7032,1517,1325,192,207,262
424,fdf277d4-7457-4b0f-a9b7-b4b9a0132f6f,44141840,7032,2114,1518,596,208,262
424,fdf277d4-7457-4b0f-a9b7-b4b9a0132f6f,44141840,7032,2307,2124,183,209,262
424,fdf277d4-7457-4b0f-a9b7-b4b9a0132f6f,44141840,7032,2466,2311,155,210,262
424,fdf277d4-7457-4b0f-a9b7-b4b9a0132f6f,44141840,7032,2830,2471,359,211,262
424,fdf277d4-7457-4b0f-a9b7-b4b9a0132f6f,44141840,7032,3618,2834,784,218,262
424,fdf277d4-7457-4b0f-a9b7-b4b9a0132f6f,44141840,7032,4474,3623,851,219,262
424,fdf277d4-7457-4b0f-a9b7-b4b9a0132f6f,44141840,7032,4592,4488,104,220,262
424,fdf277d4-7457-4b0f-a9b7-b4b9a0132f6f,44141840,7032,4654,4609,45,222,262
424,fdf277d4-7457-4b0f-a9b7-b4b9a0132f6f,44141840,7032,5054,4655,399,223,262
424,fdf277d4-7457-4b0f-a9b7-b4b9a0132f6f,44141840,7032,5057,4920,-137,224,262
424,fdf277d4-7457-4b0f-a9b7-b4b9a0132f6f,44141840,7032,5046,4924,122,229,262
424,fdf277d4-7457-4b0f-a9b7-b4b9a0132f6f,44141840,7032,5103,5047,56,230,262
424,fdf277d4-7457-4b0f-a9b7-b4b9a0132f6f,44141840,7032,5142,5104,38,231,262
424,fdf277d4-7457-4b0f-a9b7-b4b9a0132f6f,44141840,7032,5207,5143,64,232,262
424,fdf277d4-7457-4b0f-a9b7-b4b9a0132f6f,44141840,7032,5508,5212,296,262,262
422,3af222e8-310c-4058-8eda-a6dc3136235e,44170122,3326,344,10,334,0,30
422,3af222e8-310c-4058-8eda-a6dc3136235e,44170122,3326,612,349,263,1,30
422,3af222e8-310c-4058-8eda-a6dc3136235e,44170122,3326,692,617,75,2,30
422,3af222e8-310c-4058-8eda-a6dc3136235e,44170122,3326,740,699,41,3,30
422,3af222e8-310c-4058-8eda-a6dc3136235e,44170122,3326,739,728,-11,4,30
422,3af222e8-310c-4058-8eda-a6dc3136235e,44170122,3326,1060,739,321,8,30
422,3af222e8-310c-4058-8eda-a6dc3136235e,44170122,3326,1130,1061,69,14,30
422,3af222e8-310c-4058-8eda-a6dc3136235e,44170122,3326,1311,1136,175,15,30
422,3af222e8-310c-4058-8eda-a6dc3136235e,44170122,3326,1684,1324,360,18,30
422,3af222e8-310c-4058-8eda-a6dc3136235e,44170122,3326,1848,1693,155,20,30
422,3af222e8-310c-4058-8eda-a6dc3136235e,44170122,3326,1893,1852,41,21,30
422,3af222e8-310c-4058-8eda-a6dc3136235e,44170122,3326,2076,1898,178,22,30
422,3af222e8-310c-4058-8eda-a6dc3136235e,44170122,3326,2082,2079,3,23,30
422,3af222e8-310c-4058-8eda-a6dc3136235e,44170122,3326,2194,2084,110,24,30
422,3af222e8-310c-4058-8eda-a6dc3136235e,44170122,3326,2277,2195,82,25,30
422,3af222e8-310c-4058-8eda-a6dc3136235e,44170122,3326,2302,2279,23,26,30
422,3af222e8-310c-4058-8eda-a6dc3136235e,44170122,3326,2339,2305,34,29,30
422,3af222e8-310c-4058-8eda-a6dc3136235e,44170122,3326,2406,2341,65,30,30
422,3af222e8-310c-4058-8eda-a6dc3136235e,44168602,5432,53,5,48,0,21
422,3af222e8-310c-4058-8eda-a6dc3136235e,44168602,5432,459,85,374,1,21
422,3af222e8-310c-4058-8eda-a6dc3136235e,44168602,5432,592,473,119,3,21
422,3af222e8-310c-4058-8eda-a6dc3136235e,44168602,5432,759,610,149,4,21
422,3af222e8-310c-4058-8eda-a6dc3136235e,44168602,5432,795,765,30,5,21
422,3af222e8-310c-4058-8eda-a6dc3136235e,44168602,5432,973,805,168,6,21
422,3af222e8-310c-4058-8eda-a6dc3136235e,44168602,5432,1137,981,156,7,21
422,3af222e8-310c-4058-8eda-a6dc3136235e,44168602,5432,1329,1141,188,9,21
422,3af222e8-310c-4058-8eda-a6dc3136235e,44168602,5432,1582,1332,250,12,21
422,3af222e8-310c-4058-8eda-a6dc3136235e,44168602,5432,1726,1591,135,13,21
422,3af222e8-310c-4058-8eda-a6dc3136235e,44168602,5432,1860,1729,131,14,21
422,3af222e8-310c-4058-8eda-a6dc3136235e,44168602,5432,1933,1867,66,15,21
422,3af222e8-310c-4058-8eda-a6dc3136235e,44168602,5432,2094,1942,152,18,21
422,3af222e8-310c-4058-8eda-a6dc3136235e,44168602,5432,2325,2099,226,19,21
422,3af222e8-310c-4058-8eda-a6dc3136235e,44168602,5432,2596,2330,266,20,21
422,3af222e8-310c-4058-8eda-a6dc3136235e,44168602,5432,2878,2618,260,21,21
422,3af222e8-310c-4058-8eda-a6dc3136235e,44163727,7542,57,19,38,0,88
422,3af222e8-310c-4058-8eda-a6dc3136235e,44163727,7542,189,59,130,1,88
422,3af222e8-310c-4058-8eda-a6dc3136235e,44163727,7542,464,190,274,2,88
422,3af222e8-310c-4058-8eda-a6dc3136235e,44163727,7542,605,480,125,3,88
422,3af222e8-310c-4058-8eda-a6dc3136235e,44163727,7542,711,607,104,4,88
422,3af222e8-310c-4058-8eda-a6dc3136235e,44163727,7542,965,716,249,8,88
422,3af222e8-310c-4058-8eda-a6dc3136235e,44163727,7542,1025,975,50,9,88
422,3af222e8-310c-4058-8eda-a6dc3136235e,44163727,7542,1053,1026,27,10,88
422,3af222e8-310c-4058-8eda-a6dc3136235e,44163727,7542,1126,1055,71,11,88
422,3af222e8-310c-4058-8eda-a6dc3136235e,44163727,7542,1167,1128,39,12,88
422,3af222e8-310c-4058-8eda-a6dc3136235e,44163727,7542,1358,1173,185,15,88
422,3af222e8-310c-4058-8eda-a6dc3136235e,44163727,7542,1454,1372,82,16,88
422,3af222e8-310c-4058-8eda-a6dc3136235e,44163727,7542,1879,1456,423,17,88
422,3af222e8-310c-4058-8eda-a6dc3136235e,44163727,7542,1892,1814,-78,18,88
422,3af222e8-310c-4058-8eda-a6dc3136235e,44163727,7542,1870,1862,8,19,88
422,3af222e8-310c-4058-8eda-a6dc3136235e,44163727,7542,2159,1884,275,25,88
422,3af222e8-310c-4058-8eda-a6dc3136235e,44163727,7542,2404,2173,231,26,88
422,3af222e8-310c-4058-8eda-a6dc3136235e,44163727,7542,2786,2414,372,31,88
422,3af222e8-310c-4058-8eda-a6dc3136235e,44163727,7542,3069,2792,277,32,88
422,3af222e8-310c-4058-8eda-a6dc3136235e,44163727,7542,3225,3019,206,33,88
422,3af222e8-310c-4058-8eda-a6dc3136235e,44163727,7542,3226,3226,0,34,88
422,3af222e8-310c-4058-8eda-a6dc3136235e,44163727,7542,3308,3240,68,42,88
422,3af222e8-310c-4058-8eda-a6dc3136235e,44163727,7542,3505,3321,184,43,88
422,3af222e8-310c-4058-8eda-a6dc3136235e,44163727,7542,3754,3506,248,44,88
422,3af222e8-310c-4058-8eda-a6dc3136235e,44163727,7542,3836,3764,72,45,88
422,3af222e8-310c-4058-8eda-a6dc3136235e,44163727,7542,3932,3850,82,54,88
422,3af222e8-310c-4058-8eda-a6dc3136235e,44163727,7542,4152,3941,211,55,88
422,3af222e8-310c-4058-8eda-a6dc3136235e,44163727,7542,4229,4159,70,56,88
422,3af222e8-310c-4058-8eda-a6dc3136235e,44163727,7542,4332,4231,101,57,88
422,3af222e8-310c-4058-8eda-a6dc3136235e,44163727,7542,4345,4333,12,58,88
422,3af222e8-310c-4058-8eda-a6dc3136235e,44163727,7542,4594,4349,245,61,88
422,3af222e8-310c-4058-8eda-a6dc3136235e,44163727,7542,4659,4595,64,63,88
422,3af222e8-310c-4058-8eda-a6dc3136235e,44163727,7542,4783,4667,116,64,88
422,3af222e8-310c-4058-8eda-a6dc3136235e,44163727,7542,4789,4786,3,65,88
422,3af222e8-310c-4058-8eda-a6dc3136235e,44163727,7542,5027,4791,236,68,88
422,3af222e8-310c-4058-8eda-a6dc3136235e,44163727,7542,5033,5029,4,69,88
422,3af222e8-310c-4058-8eda-a6dc3136235e,44163727,7542,5337,5038,299,74,88
422,3af222e8-310c-4058-8eda-a6dc3136235e,44163727,7542,5587,5338,249,75,88
422,3af222e8-310c-4058-8eda-a6dc3136235e,44163727,7542,5779,5592,187,76,88
422,3af222e8-310c-4058-8eda-a6dc3136235e,44163727,7542,5932,5794,138,82,88
422,3af222e8-310c-4058-8eda-a6dc3136235e,44163727,7542,6255,5943,312,83,88
422,3af222e8-310c-4058-8eda-a6dc3136235e,44163727,7542,6582,6270,312,87,88
422,3af222e8-310c-4058-8eda-a6dc3136235e,44163727,7542,6622,6598,24,88,88
422,3af222e8-310c-4058-8eda-a6dc3136235e,44169350,4808,104,8,96,0,65
422,3af222e8-310c-4058-8eda-a6dc3136235e,44169350,4808,516,15,501,1,65
422,3af222e8-310c-4058-8eda-a6dc3136235e,44169350,4808,762,526,236,2,65
422,3af222e8-310c-4058-8eda-a6dc3136235e,44169350,4808,832,764,68,3,65
422,3af222e8-310c-4058-8eda-a6dc3136235e,44169350,4808,834,834,0,10,65
422,3af222e8-310c-4058-8eda-a6dc3136235e,44169350,4808,1089,840,249,11,65
422,3af222e8-310c-4058-8eda-a6dc3136235e,44169350,4808,1264,1095,169,14,65
422,3af222e8-310c-4058-8eda-a6dc3136235e,44169350,4808,1338,1273,65,15,65
422,3af222e8-310c-4058-8eda-a6dc3136235e,44169350,4808,1507,1343,164,16,65
422,3af222e8-310c-4058-8eda-a6dc3136235e,44169350,4808,1614,1525,89,21,65
422,3af222e8-310c-4058-8eda-a6dc3136235e,44169350,4808,1794,1619,175,22,65
422,3af222e8-310c-4058-8eda-a6dc3136235e,44169350,4808,1972,1797,175,23,65
422,3af222e8-310c-4058-8eda-a6dc3136235e,44169350,4808,2434,1981,453,35,65
422,3af222e8-310c-4058-8eda-a6dc3136235e,44169350,4808,2543,2435,108,36,65
422,3af222e8-310c-4058-8eda-a6dc3136235e,44169350,4808,2550,2544,6,37,65
422,3af222e8-310c-4058-8eda-a6dc3136235e,44169350,4808,2815,2558,257,42,65
422,3af222e8-310c-4058-8eda-a6dc3136235e,44169350,4808,3023,2816,207,43,65
422,3af222e8-310c-4058-8eda-a6dc3136235e,44169350,4808,3036,3025,11,44,65
422,3af222e8-310c-4058-8eda-a6dc3136235e,44169350,4808,3184,3043,141,53,65
422,3af222e8-310c-4058-8eda-a6dc3136235e,44169350,4808,3208,3187,21,54,65
422,3af222e8-310c-4058-8eda-a6dc3136235e,44169350,4808,3423,3213,210,55,65
422,3af222e8-310c-4058-8eda-a6dc3136235e,44169350,4808,3537,3426,111,56,65
422,3af222e8-310c-4058-8eda-a6dc3136235e,44169350,4808,3572,3541,31,57,65
422,3af222e8-310c-4058-8eda-a6dc3136235e,44169350,4808,3756,3589,167,64,65
422,3af222e8-310c-4058-8eda-a6dc3136235e,44169350,4808,3888,3762,126,65,65
423,b0c25ded-18c3-4654-a57e-522c660dcac1,44173954,7927,490,7,483,0,161
423,b0c25ded-18c3-4654-a57e-522c660dcac1,44173954,7927,757,491,266,1,161
423,b0c25ded-18c3-4654-a57e-522c660dcac1,44173954,7927,784,764,20,2,161
423,b0c25ded-18c3-4654-a57e-522c660dcac1,44173954,7927,847,786,61,4,161
423,b0c25ded-18c3-4654-a57e-522c660dcac1,44173954,7927,947,857,90,5,161
423,b0c25ded-18c3-4654-a57e-522c660dcac1,44173954,7927,1411,974,437,14,161
423,b0c25ded-18c3-4654-a57e-522c660dcac1,44173954,7927,1614,1416,198,19,161
423,b0c25ded-18c3-4654-a57e-522c660dcac1,44173954,7927,1674,1618,56,23,161
423,b0c25ded-18c3-4654-a57e-522c660dcac1,44173954,7927,1805,1684,121,24,161
423,b0c25ded-18c3-4654-a57e-522c660dcac1,44173954,7927,2038,1817,221,31,161
423,b0c25ded-18c3-4654-a57e-522c660dcac1,44173954,7927,2162,2050,112,37,161
423,b0c25ded-18c3-4654-a57e-522c660dcac1,44173954,7927,2194,2172,22,38,161
423,b0c25ded-18c3-4654-a57e-522c660dcac1,44173954,7927,2256,2205,51,40,161
423,b0c25ded-18c3-4654-a57e-522c660dcac1,44173954,7927,2408,2273,135,41,161
423,b0c25ded-18c3-4654-a57e-522c660dcac1,44173954,7927,2682,2426,256,49,161
423,b0c25ded-18c3-4654-a57e-522c660dcac1,44173954,7927,2906,2688,218,55,161
423,b0c25ded-18c3-4654-a57e-522c660dcac1,44173954,7927,3027,2909,118,56,161
423,b0c25ded-18c3-4654-a57e-522c660dcac1,44173954,7927,3089,3034,55,57,161
423,b0c25ded-18c3-4654-a57e-522c660dcac1,44173954,7927,3114,3091,23,58,161
423,b0c25ded-18c3-4654-a57e-522c660dcac1,44173954,7927,3288,3126,162,65,161
423,b0c25ded-18c3-4654-a57e-522c660dcac1,44173954,7927,3290,3290,0,66,161
423,b0c25ded-18c3-4654-a57e-522c660dcac1,44173954,7927,3355,3296,59,73,161
423,b0c25ded-18c3-4654-a57e-522c660dcac1,44173954,7927,3358,3357,1,74,161
423,b0c25ded-18c3-4654-a57e-522c660dcac1,44173954,7927,3443,3365,78,78,161
423,b0c25ded-18c3-4654-a57e-522c660dcac1,44173954,7927,3597,3457,140,85,161
423,b0c25ded-18c3-4654-a57e-522c660dcac1,44173954,7927,3613,3599,14,86,161
423,b0c25ded-18c3-4654-a57e-522c660dcac1,44173954,7927,3818,3615,203,91,161
423,b0c25ded-18c3-4654-a57e-522c660dcac1,44173954,7927,4011,3826,185,96,161
423,b0c25ded-18c3-4654-a57e-522c660dcac1,44173954,7927,4046,4024,22,100,161
423,b0c25ded-18c3-4654-a57e-522c660dcac1,44173954,7927,4227,4067,160,101,161
423,b0c25ded-18c3-4654-a57e-522c660dcac1,44173954,7927,4451,4230,221,103,161
423,b0c25ded-18c3-4654-a57e-522c660dcac1,44173954,7927,4696,4463,233,109,161
423,b0c25ded-18c3-4654-a57e-522c660dcac1,44173954,7927,4823,4703,120,112,161
423,b0c25ded-18c3-4654-a57e-522c660dcac1,44173954,7927,4887,4833,54,113,161
423,b0c25ded-18c3-4654-a57e-522c660dcac1,44173954,7927,5067,4899,168,122,161
423,b0c25ded-18c3-4654-a57e-522c660dcac1,44173954,7927,5230,5068,162,126,161
423,b0c25ded-18c3-4654-a57e-522c660dcac1,44173954,7927,5285,5238,47,131,161
423,b0c25ded-18c3-4654-a57e-522c660dcac1,44173954,7927,5290,5287,3,132,161
423,b0c25ded-18c3-4654-a57e-522c660dcac1,44173954,7927,5440,5306,134,139,161
423,b0c25ded-18c3-4654-a57e-522c660dcac1,44173954,7927,5639,5449,190,140,161
423,b0c25ded-18c3-4654-a57e-522c660dcac1,44173954,7927,5645,5368,-277,141,161
423,b0c25ded-18c3-4654-a57e-522c660dcac1,44173954,7927,5606,5597,9,142,161
423,b0c25ded-18c3-4654-a57e-522c660dcac1,44173954,7927,5713,5616,97,152,161
423,b0c25ded-18c3-4654-a57e-522c660dcac1,44173954,7927,5752,5715,37,153,161
423,b0c25ded-18c3-4654-a57e-522c660dcac1,44173954,7927,5708,5495,-213,157,161
423,b0c25ded-18c3-4654-a57e-522c660dcac1,44173954,7927,5868,5595,273,158,161
423,b0c25ded-18c3-4654-a57e-522c660dcac1,44173954,7927,6029,5871,158,159,161
423,b0c25ded-18c3-4654-a57e-522c660dcac1,44173954,7927,6180,6053,127,161,161
423,b0c25ded-18c3-4654-a57e-522c660dcac1,44176899,3388,218,3,215,0,38
423,b0c25ded-18c3-4654-a57e-522c660dcac1,44176899,3388,660,237,423,3,38
423,b0c25ded-18c3-4654-a57e-522c660dcac1,44176899,3388,736,662,74,4,38
423,b0c25ded-18c3-4654-a57e-522c660dcac1,44176899,3388,1098,741,357,8,38
423,b0c25ded-18c3-4654-a57e-522c660dcac1,44176899,3388,1033,349,-684,10,38
423,b0c25ded-18c3-4654-a57e-522c660dcac1,44176899,3388,689,348,341,11,38
423,b0c25ded-18c3-4654-a57e-522c660dcac1,44176899,3388,978,701,277,12,38
423,b0c25ded-18c3-4654-a57e-522c660dcac1,44176899,3388,1037,981,56,13,38
423,b0c25ded-18c3-4654-a57e-522c660dcac1,44176899,3388,1330,1038,292,14,38
423,b0c25ded-18c3-4654-a57e-522c660dcac1,44176899,3388,1406,1335,71,15,38
423,b0c25ded-18c3-4654-a57e-522c660dcac1,44176899,3388,1543,1409,134,19,38
423,b0c25ded-18c3-4654-a57e-522c660dcac1,44176899,3388,1636,1535,-101,30,38
423,b0c25ded-18c3-4654-a57e-522c660dcac1,44176899,3388,1516,1372,-144,33,38
423,b0c25ded-18c3-4654-a57e-522c660dcac1,44176899,3388,1439,1373,66,34,38
423,b0c25ded-18c3-4654-a57e-522c660dcac1,44176899,3388,1641,1452,189,38,38
423,b0c25ded-18c3-4654-a57e-522c660dcac1,44165718,8328,213,4,209,0,87
423,b0c25ded-18c3-4654-a57e-522c660dcac1,44165718,8328,408,224,184,1,87
423,b0c25ded-18c3-4654-a57e-522c660dcac1,44165718,8328,605,417,188,2,87
423,b0c25ded-18c3-4654-a57e-522c660dcac1,44165718,8328,763,330,-433,5,87
423,b0c25ded-18c3-4654-a57e-522c660dcac1,44165718,8328,942,329,613,6,87
423,b0c25ded-18c3-4654-a57e-522c660dcac1,44165718,8328,952,410,-542,7,87
423,b0c25ded-18c3-4654-a57e-522c660dcac1,44165718,8328,949,409,540,8,87
423,b0c25ded-18c3-4654-a57e-522c660dcac1,44165718,8328,1019,964,55,16,87
423,b0c25ded-18c3-4654-a57e-522c660dcac1,44165718,8328,1189,1046,143,17,87
423,b0c25ded-18c3-4654-a57e-522c660dcac1,44165718,8328,1344,1191,153,21,87
423,b0c25ded-18c3-4654-a57e-522c660dcac1,44165718,8328,1348,1345,3,22,87
423,b0c25ded-18c3-4654-a57e-522c660dcac1,44165718,8328,1532,1350,182,25,87
423,b0c25ded-18c3-4654-a57e-522c660dcac1,44165718,8328,1577,1533,44,26,87
423,b0c25ded-18c3-4654-a57e-522c660dcac1,44165718,8328,1649,1580,69,31,87
423,b0c25ded-18c3-4654-a57e-522c660dcac1,44165718,8328,1730,1651,79,32,87
423,b0c25ded-18c3-4654-a57e-522c660dcac1,44165718,8328,1826,1731,95,43,87
423,b0c25ded-18c3-4654-a57e-522c660dcac1,44165718,8328,2009,1832,177,48,87
423,b0c25ded-18c3-4654-a57e-522c660dcac1,44165718,8328,2068,2010,58,53,87
423,b0c25ded-18c3-4654-a57e-522c660dcac1,44165718,8328,2086,2068,-18,54,87
423,b0c25ded-18c3-4654-a57e-522c660dcac1,44165718,8328,2091,2069,22,55,87
423,b0c25ded-18c3-4654-a57e-522c660dcac1,44165718,8328,2103,2090,13,56,87
423,b0c25ded-18c3-4654-a57e-522c660dcac1,44165718,8328,2110,2104,6,57,87
423,b0c25ded-18c3-4654-a57e-522c660dcac1,44165718,8328,2249,2111,138,58,87
423,b0c25ded-18c3-4654-a57e-522c660dcac1,44165718,8328,2353,2252,101,64,87
423,b0c25ded-18c3-4654-a57e-522c660dcac1,44165718,8328,2366,2354,12,65,87
423,b0c25ded-18c3-4654-a57e-522c660dcac1,44165718,8328,2499,2375,124,68,87
423,b0c25ded-18c3-4654-a57e-522c660dcac1,44165718,8328,2532,2503,29,69,87
423,b0c25ded-18c3-4654-a57e-522c660dcac1,44165718,8328,2622,2534,88,73,87
423,b0c25ded-18c3-4654-a57e-522c660dcac1,44165718,8328,2745,2624,121,77,87
423,b0c25ded-18c3-4654-a57e-522c660dcac1,44165718,8328,2754,2747,7,78,87
423,b0c25ded-18c3-4654-a57e-522c660dcac1,44165718,8328,2955,2757,198,81,87
423,b0c25ded-18c3-4654-a57e-522c660dcac1,44165718,8328,3802,2961,841,85,87
423,b0c25ded-18c3-4654-a57e-522c660dcac1,44165718,8328,6195,3814,2381,86,87
423,b0c25ded-18c3-4654-a57e-522c660dcac1,44165718,8328,6220,6199,21,87,87
423,b0c25ded-18c3-4654-a57e-522c660dcac1,44166773,3430,123,11,112,0,21
423,b0c25ded-18c3-4654-a57e-522c660dcac1,44166773,3430,497,143,354,1,21
423,b0c25ded-18c3-4654-a57e-522c660dcac1,44166773,3430,586,507,79,2,21
423,b0c25ded-18c3-4654-a57e-522c660dcac1,44166773,3430,649,471,178,3,21
423,b0c25ded-18c3-4654-a57e-522c660dcac1,44166773,3430,829,655,174,4,21
423,b0c25ded-18c3-4654-a57e-522c660dcac1,44166773,3430,938,835,103,12,21
423,b0c25ded-18c3-4654-a57e-522c660dcac1,44166773,3430,1035,945,90,13,21
423,b0c25ded-18c3-4654-a57e-522c660dcac1,44166773,3430,1471,1058,413,21,21
423,b0c25ded-18c3-4654-a57e-522c660dcac1,44167000,2645,435,4,431,0,12
423,b0c25ded-18c3-4654-a57e-522c660dcac1,44167000,2645,672,438,234,1,12
423,b0c25ded-18c3-4654-a57e-522c660dcac1,44167000,2645,783,676,107,2,12
423,b0c25ded-18c3-4654-a57e-522c660dcac1,44167000,2645,898,790,108,3,12
423,b0c25ded-18c3-4654-a57e-522c660dcac1,44167000,2645,897,897,0,4,12
423,b0c25ded-18c3-4654-a57e-522c660dcac1,44167000,2645,898,898,0,12,12
424,62d29497-c3cf-4193-a2d3-c782885f7f56,44187718,12876,149,149,0,0,1076
424,62d29497-c3cf-4193-a2d3-c782885f7f56,44187718,12876,401,155,246,1,1076
424,62d29497-c3cf-4193-a2d3-c782885f7f56,44187718,12876,674,407,267,2,1076
424,62d29497-c3cf-4193-a2d3-c782885f7f56,44187718,12876,738,684,54,3,1076
424,62d29497-c3cf-4193-a2d3-c782885f7f56,44187718,12876,1172,790,382,11,1076
424,62d29497-c3cf-4193-a2d3-c782885f7f56,44187718,12876,1409,1176,233,26,1076
424,62d29497-c3cf-4193-a2d3-c782885f7f56,44187718,12876,1502,1418,84,36,1076
424,62d29497-c3cf-4193-a2d3-c782885f7f56,44187718,12876,1707,1515,192,37,1076
424,62d29497-c3cf-4193-a2d3-c782885f7f56,44187718,12876,1733,1708,25,38,1076
424,62d29497-c3cf-4193-a2d3-c782885f7f56,44187718,12876,1895,1741,154,39,1076
424,62d29497-c3cf-4193-a2d3-c782885f7f56,44187718,12876,1950,1904,46,40,1076
424,62d29497-c3cf-4193-a2d3-c782885f7f56,44187718,12876,3722,1961,1761,149,1076
424,62d29497-c3cf-4193-a2d3-c782885f7f56,44187718,12876,3787,3396,-391,150,1076
424,62d29497-c3cf-4193-a2d3-c782885f7f56,44187718,12876,3389,3313,-76,151,1076
424,62d29497-c3cf-4193-a2d3-c782885f7f56,44187718,12876,3303,3261,-42,152,1076
424,62d29497-c3cf-4193-a2d3-c782885f7f56,44187718,12876,3368,3265,103,155,1076
424,62d29497-c3cf-4193-a2d3-c782885f7f56,44187718,12876,3423,3370,53,156,1076
424,62d29497-c3cf-4193-a2d3-c782885f7f56,44187718,12876,3610,3438,172,289,1076
424,62d29497-c3cf-4193-a2d3-c782885f7f56,44187718,12876,3705,3611,94,319,1076
424,62d29497-c3cf-4193-a2d3-c782885f7f56,44187718,12876,3862,3710,152,320,1076
424,62d29497-c3cf-4193-a2d3-c782885f7f56,44187718,12876,3873,3864,9,321,1076
424,62d29497-c3cf-4193-a2d3-c782885f7f56,44187718,12876,3865,3585,-280,341,1076
424,62d29497-c3cf-4193-a2d3-c782885f7f56,44187718,12876,3584,3521,-63,342,1076
424,62d29497-c3cf-4193-a2d3-c782885f7f56,44187718,12876,3791,3519,272,343,1076
424,62d29497-c3cf-4193-a2d3-c782885f7f56,44187718,12876,3975,3799,176,344,1076
424,62d29497-c3cf-4193-a2d3-c782885f7f56,44187718,12876,4097,3982,115,345,1076
424,62d29497-c3cf-4193-a2d3-c782885f7f56,44187718,12876,4607,4106,501,347,1076
424,62d29497-c3cf-4193-a2d3-c782885f7f56,44187718,12876,4748,4616,132,348,1076
424,62d29497-c3cf-4193-a2d3-c782885f7f56,44187718,12876,5101,4771,330,364,1076
424,62d29497-c3cf-4193-a2d3-c782885f7f56,44187718,12876,5397,5124,273,370,1076
424,62d29497-c3cf-4193-a2d3-c782885f7f56,44187718,12876,6734,5480,1254,371,1076
424,62d29497-c3cf-4193-a2d3-c782885f7f56,44187718,12876,6888,6745,143,393,1076
424,62d29497-c3cf-4193-a2d3-c782885f7f56,44187718,12876,6943,6889,54,394,1076
424,62d29497-c3cf-4193-a2d3-c782885f7f56,44187718,12876,7286,6953,333,410,1076
424,62d29497-c3cf-4193-a2d3-c782885f7f56,44187718,12876,7452,7288,164,411,1076
424,62d29497-c3cf-4193-a2d3-c782885f7f56,44187718,12876,7586,7574,12,412,1076
424,62d29497-c3cf-4193-a2d3-c782885f7f56,44187718,12876,7836,7590,246,414,1076
424,62d29497-c3cf-4193-a2d3-c782885f7f56,44187718,12876,7838,7837,1,415,1076
424,62d29497-c3cf-4193-a2d3-c782885f7f56,44187718,12876,7915,7841,74,421,1076
424,62d29497-c3cf-4193-a2d3-c782885f7f56,44187718,12876,8005,7917,88,422,1076
424,62d29497-c3cf-4193-a2d3-c782885f7f56,44187718,12876,8035,8006,29,423,1076
424,62d29497-c3cf-4193-a2d3-c782885f7f56,44187718,12876,8153,8046,107,431,1076
424,62d29497-c3cf-4193-a2d3-c782885f7f56,44187718,12876,8176,8154,22,432,1076
424,62d29497-c3cf-4193-a2d3-c782885f7f56,44187718,12876,8180,8177,3,433,1076
424,62d29497-c3cf-4193-a2d3-c782885f7f56,44187718,12876,8276,8181,95,442,1076
424,62d29497-c3cf-4193-a2d3-c782885f7f56,44187718,12876,8380,8284,96,443,1076
424,62d29497-c3cf-4193-a2d3-c782885f7f56,44187718,12876,8501,8382,119,444,1076
424,62d29497-c3cf-4193-a2d3-c782885f7f56,44187718,12876,8502,8502,0,445,1076
424,62d29497-c3cf-4193-a2d3-c782885f7f56,44187718,12876,8605,8504,101,446,1076
424,62d29497-c3cf-4193-a2d3-c782885f7f56,44187718,12876,8660,8606,54,447,1076
424,62d29497-c3cf-4193-a2d3-c782885f7f56,44187718,12876,8686,8661,25,448,1076
424,62d29497-c3cf-4193-a2d3-c782885f7f56,44187718,12876,8913,8694,219,450,1076
424,62d29497-c3cf-4193-a2d3-c782885f7f56,44187718,12876,9052,8916,136,451,1076
424,62d29497-c3cf-4193-a2d3-c782885f7f56,44187718,12876,9177,9070,107,452,1076
424,62d29497-c3cf-4193-a2d3-c782885f7f56,44187718,12876,9197,9178,19,453,1076
424,62d29497-c3cf-4193-a2d3-c782885f7f56,44187718,12876,9440,9200,240,457,1076
424,62d29497-c3cf-4193-a2d3-c782885f7f56,44187718,12876,9540,9444,96,458,1076
424,62d29497-c3cf-4193-a2d3-c782885f7f56,44187718,12876,9688,9548,140,459,1076
424,62d29497-c3cf-4193-a2d3-c782885f7f56,44187718,12876,10034,9696,338,460,1076
424,62d29497-c3cf-4193-a2d3-c782885f7f56,44187718,12876,10255,10049,206,461,1076
424,62d29497-c3cf-4193-a2d3-c782885f7f56,44187718,12876,10706,10263,443,464,1076
424,62d29497-c3cf-4193-a2d3-c782885f7f56,44187718,12876,10708,10707,1,465,1076
424,62d29497-c3cf-4193-a2d3-c782885f7f56,44187718,12876,11308,10753,555,470,1076
424,62d29497-c3cf-4193-a2d3-c782885f7f56,44187718,12876,11310,11309,1,471,1076
424,62d29497-c3cf-4193-a2d3-c782885f7f56,44187718,12876,11352,11352,0,1076,1076
424,62d29497-c3cf-4193-a2d3-c782885f7f56,44160630,4560,295,16,279,0,124
424,62d29497-c3cf-4193-a2d3-c782885f7f56,44160630,4560,354,307,47,1,124
424,62d29497-c3cf-4193-a2d3-c782885f7f56,44160630,4560,644,388,256,17,124
424,62d29497-c3cf-4193-a2d3-c782885f7f56,44160630,4560,1328,651,677,18,124
424,62d29497-c3cf-4193-a2d3-c782885f7f56,44160630,4560,1731,1332,399,58,124
424,62d29497-c3cf-4193-a2d3-c782885f7f56,44160630,4560,1770,1770,0,61,124
424,62d29497-c3cf-4193-a2d3-c782885f7f56,44160630,4560,2495,1821,674,62,124
424,62d29497-c3cf-4193-a2d3-c782885f7f56,44160630,4560,2585,2501,84,68,124
424,62d29497-c3cf-4193-a2d3-c782885f7f56,44160630,4560,2586,2586,0,69,124
424,62d29497-c3cf-4193-a2d3-c782885f7f56,44160630,4560,3036,2609,427,124,124
424,62d29497-c3cf-4193-a2d3-c782885f7f56,44174112,4008,448,164,284,0,27
424,62d29497-c3cf-4193-a2d3-c782885f7f56,44174112,4008,660,449,211,2,27
424,62d29497-c3cf-4193-a2d3-c782885f7f56,44174112,4008,825,664,161,3,27
424,62d29497-c3cf-4193-a2d3-c782885f7f56,44174112,4008,994,837,157,5,27
424,62d29497-c3cf-4193-a2d3-c782885f7f56,44174112,4008,1511,1023,488,22,27
424,62d29497-c3cf-4193-a2d3-c782885f7f56,44174112,4008,1557,1522,35,23,27
424,62d29497-c3cf-4193-a2d3-c782885f7f56,44174112,4008,1812,1568,244,26,27
424,62d29497-c3cf-4193-a2d3-c782885f7f56,44174112,4008,2231,1814,417,27,27
411,c2ea1a50-1770-43f6-a88b-bd3d84825652,44190742,7590,171,7,164,0,11
411,c2ea1a50-1770-43f6-a88b-bd3d84825652,44190742,7590,699,179,520,1,11
411,c2ea1a50-1770-43f6-a88b-bd3d84825652,44190742,7590,749,705,44,4,11
411,c2ea1a50-1770-43f6-a88b-bd3d84825652,44190742,7590,820,750,70,5,11
411,c2ea1a50-1770-43f6-a88b-bd3d84825652,44190742,7590,905,822,83,6,11
411,c2ea1a50-1770-43f6-a88b-bd3d84825652,44190742,7590,1467,907,560,7,11
411,c2ea1a50-1770-43f6-a88b-bd3d84825652,44190742,7590,1945,1495,450,8,11
411,c2ea1a50-1770-43f6-a88b-bd3d84825652,44190742,7590,1963,1946,17,9,11
411,c2ea1a50-1770-43f6-a88b-bd3d84825652,44190742,7590,2396,1976,420,10,11
411,c2ea1a50-1770-43f6-a88b-bd3d84825652,44190742,7590,3245,2435,810,11,11
411,c2ea1a50-1770-43f6-a88b-bd3d84825652,44187838,9858,303,9,294,0,30
411,c2ea1a50-1770-43f6-a88b-bd3d84825652,44187838,9858,493,309,184,8,30
411,c2ea1a50-1770-43f6-a88b-bd3d84825652,44187838,9858,577,497,80,25,30
411,c2ea1a50-1770-43f6-a88b-bd3d84825652,44187838,9858,807,581,226,26,30
411,c2ea1a50-1770-43f6-a88b-bd3d84825652,44187838,9858,923,820,103,27,30
411,c2ea1a50-1770-43f6-a88b-bd3d84825652,44187838,9858,1014,932,82,28,30
411,c2ea1a50-1770-43f6-a88b-bd3d84825652,44187838,9858,1128,1022,106,29,30
411,c2ea1a50-1770-43f6-a88b-bd3d84825652,44187838,9858,1286,1131,155,30,30
411,c2ea1a50-1770-43f6-a88b-bd3d84825652,44171204,4773,223,2,221,0,12
411,c2ea1a50-1770-43f6-a88b-bd3d84825652,44171204,4773,469,228,241,1,12
411,c2ea1a50-1770-43f6-a88b-bd3d84825652,44171204,4773,490,476,14,2,12
411,c2ea1a50-1770-43f6-a88b-bd3d84825652,44171204,4773,621,495,126,4,12
411,c2ea1a50-1770-43f6-a88b-bd3d84825652,44171204,4773,753,630,123,5,12
411,c2ea1a50-1770-43f6-a88b-bd3d84825652,44171204,4773,848,757,91,6,12
411,c2ea1a50-1770-43f6-a88b-bd3d84825652,44171204,4773,1090,853,237,8,12
411,c2ea1a50-1770-43f6-a88b-bd3d84825652,44171204,4773,1197,1095,102,9,12
411,c2ea1a50-1770-43f6-a88b-bd3d84825652,44171204,4773,1332,1203,129,10,12
411,c2ea1a50-1770-43f6-a88b-bd3d84825652,44171204,4773,1549,1345,204,12,12
411,c2ea1a50-1770-43f6-a88b-bd3d84825652,44192297,3540,332,5,327,0,33
411,c2ea1a50-1770-43f6-a88b-bd3d84825652,44192297,3540,724,339,385,1,33
411,c2ea1a50-1770-43f6-a88b-bd3d84825652,44192297,3540,930,727,203,2,33
411,c2ea1a50-1770-43f6-a88b-bd3d84825652,44192297,3540,1054,932,122,18,33
411,c2ea1a50-1770-43f6-a88b-bd3d84825652,44192297,3540,1237,1064,173,19,33
411,c2ea1a50-1770-43f6-a88b-bd3d84825652,44192297,3540,1341,1238,103,20,33
411,c2ea1a50-1770-43f6-a88b-bd3d84825652,44192297,3540,1493,1365,128,26,33
411,c2ea1a50-1770-43f6-a88b-bd3d84825652,44192297,3540,1973,1533,440,27,33
411,c2ea1a50-1770-43f6-a88b-bd3d84825652,44192297,3540,2044,1974,70,28,33
411,c2ea1a50-1770-43f6-a88b-bd3d84825652,44192297,3540,2084,2048,36,29,33
411,c2ea1a50-1770-43f6-a88b-bd3d84825652,44192297,3540,2160,2110,50,33,33
411,ff514263-a78c-4702-9b37-718022e7b7f6,44187718,12588,239,3,236,0,40
411,ff514263-a78c-4702-9b37-718022e7b7f6,44187718,12588,319,254,65,1,40
411,ff514263-a78c-4702-9b37-718022e7b7f6,44187718,12588,609,336,273,23,40
411,ff514263-a78c-4702-9b37-718022e7b7f6,44187718,12588,800,622,178,24,40
411,ff514263-a78c-4702-9b37-718022e7b7f6,44187718,12588,939,815,124,25,40
411,ff514263-a78c-4702-9b37-718022e7b7f6,44187718,12588,1135,955,180,27,40
411,ff514263-a78c-4702-9b37-718022e7b7f6,44187718,12588,1271,1143,128,28,40
411,ff514263-a78c-4702-9b37-718022e7b7f6,44187718,12588,1420,1272,148,29,40
411,ff514263-a78c-4702-9b37-718022e7b7f6,44187718,12588,1690,1421,269,30,40
411,ff514263-a78c-4702-9b37-718022e7b7f6,44187718,12588,2279,1691,588,31,40
411,ff514263-a78c-4702-9b37-718022e7b7f6,44187718,12588,3590,2367,1223,32,40
411,ff514263-a78c-4702-9b37-718022e7b7f6,44187718,12588,3783,3600,183,35,40
411,ff514263-a78c-4702-9b37-718022e7b7f6,44187718,12588,4529,3811,718,36,40
411,ff514263-a78c-4702-9b37-718022e7b7f6,44187718,12588,4860,4538,322,37,40
411,ff514263-a78c-4702-9b37-718022e7b7f6,44187718,12588,5779,4881,898,38,40
411,ff514263-a78c-4702-9b37-718022e7b7f6,44187718,12588,6633,5786,847,39,40
411,ff514263-a78c-4702-9b37-718022e7b7f6,44187718,12588,6734,6641,93,40,40
411,ff514263-a78c-4702-9b37-718022e7b7f6,44192075,18510,243,18,225,0,6
411,ff514263-a78c-4702-9b37-718022e7b7f6,44192075,18510,1172,262,910,1,6
411,ff514263-a78c-4702-9b37-718022e7b7f6,44192075,18510,1333,1173,160,2,6
411,ff514263-a78c-4702-9b37-718022e7b7f6,44192075,18510,1457,1343,114,3,6
411,ff514263-a78c-4702-9b37-718022e7b7f6,44192075,18510,2253,1460,793,4,6
411,ff514263-a78c-4702-9b37-718022e7b7f6,44192075,18510,3026,2258,768,5,6
411,ff514263-a78c-4702-9b37-718022e7b7f6,44192075,18510,4683,3030,1653,6,6
411,ff514263-a78c-4702-9b37-718022e7b7f6,44191444,5421,396,27,369,0,14
411,ff514263-a78c-4702-9b37-718022e7b7f6,44191444,5421,499,409,90,2,14
411,ff514263-a78c-4702-9b37-718022e7b7f6,44191444,5421,545,502,43,3,14
411,ff514263-a78c-4702-9b37-718022e7b7f6,44191444,5421,684,553,131,4,14
411,ff514263-a78c-4702-9b37-718022e7b7f6,44191444,5421,842,688,154,5,14
411,ff514263-a78c-4702-9b37-718022e7b7f6,44191444,5421,1018,860,158,6,14
411,ff514263-a78c-4702-9b37-718022e7b7f6,44191444,5421,1275,1029,246,7,14
411,ff514263-a78c-4702-9b37-718022e7b7f6,44191444,5421,1848,1291,557,8,14
411,ff514263-a78c-4702-9b37-718022e7b7f6,44191444,5421,2082,1849,233,9,14
411,ff514263-a78c-4702-9b37-718022e7b7f6,44191444,5421,2387,2084,303,10,14
411,ff514263-a78c-4702-9b37-718022e7b7f6,44191444,5421,3212,2390,822,11,14
411,ff514263-a78c-4702-9b37-718022e7b7f6,44191444,5421,3234,3217,17,12,14
411,ff514263-a78c-4702-9b37-718022e7b7f6,44191444,5421,3873,3266,607,13,14
411,ff514263-a78c-4702-9b37-718022e7b7f6,44191444,5421,4041,3906,135,14,14
412,1ed2425e-8ecc-4729-9163-1220984af832,44191444,5574,661,17,644,0,52
412,1ed2425e-8ecc-4729-9163-1220984af832,44191444,5574,1122,666,456,7,52
412,1ed2425e-8ecc-4729-9163-1220984af832,44191444,5574,1149,1129,20,8,52
412,1ed2425e-8ecc-4729-9163-1220984af832,44191444,5574,1751,1181,570,17,52
412,1ed2425e-8ecc-4729-9163-1220984af832,44191444,5574,2486,1764,722,22,52
412,1ed2425e-8ecc-4729-9163-1220984af832,44191444,5574,3128,2496,632,34,52
412,1ed2425e-8ecc-4729-9163-1220984af832,44191444,5574,3574,3144,430,45,52
412,1ed2425e-8ecc-4729-9163-1220984af832,44191444,5574,3923,3590,333,51,52
412,1ed2425e-8ecc-4729-9163-1220984af832,44191444,5574,4050,3956,94,52,52
412,1ed2425e-8ecc-4729-9163-1220984af832,44193145,6105,620,7,613,0,75
412,1ed2425e-8ecc-4729-9163-1220984af832,44193145,6105,1178,637,541,12,75
412,1ed2425e-8ecc-4729-9163-1220984af832,44193145,6105,1644,1183,461,13,75
412,1ed2425e-8ecc-4729-9163-1220984af832,44193145,6105,1933,1653,280,17,75
412,1ed2425e-8ecc-4729-9163-1220984af832,44193145,6105,1934,1934,0,18,75
412,1ed2425e-8ecc-4729-9163-1220984af832,44193145,6105,2462,1961,501,35,75
412,1ed2425e-8ecc-4729-9163-1220984af832,44193145,6105,3145,2493,652,46,75
412,1ed2425e-8ecc-4729-9163-1220984af832,44193145,6105,3989,3183,806,61,75
412,1ed2425e-8ecc-4729-9163-1220984af832,44193145,6105,4029,3997,32,62,75
412,1ed2425e-8ecc-4729-9163-1220984af832,44193145,6105,4428,4073,355,75,75
422,8c5cc626-816e-427e-83ab-0955940f0ced,44190742,8792,374,24,350,0,109
422,8c5cc626-816e-427e-83ab-0955940f0ced,44190742,8792,527,377,150,1,109
422,8c5cc626-816e-427e-83ab-0955940f0ced,44190742,8792,679,534,145,2,109
422,8c5cc626-816e-427e-83ab-0955940f0ced,44190742,8792,837,686,151,9,109
422,8c5cc626-816e-427e-83ab-0955940f0ced,44190742,8792,1091,849,242,10,109
422,8c5cc626-816e-427e-83ab-0955940f0ced,44190742,8792,1218,1096,122,11,109
422,8c5cc626-816e-427e-83ab-0955940f0ced,44190742,8792,1422,1219,203,14,109
422,8c5cc626-816e-427e-83ab-0955940f0ced,44190742,8792,1452,1424,28,15,109
422,8c5cc626-816e-427e-83ab-0955940f0ced,44190742,8792,1642,1461,181,22,109
422,8c5cc626-816e-427e-83ab-0955940f0ced,44190742,8792,1726,1646,80,23,109
422,8c5cc626-816e-427e-83ab-0955940f0ced,44190742,8792,1955,1729,226,24,109
422,8c5cc626-816e-427e-83ab-0955940f0ced,44190742,8792,2072,1957,115,25,109
422,8c5cc626-816e-427e-83ab-0955940f0ced,44190742,8792,2064,1901,-163,26,109
422,8c5cc626-816e-427e-83ab-0955940f0ced,44190742,8792,2101,1942,159,27,109
422,8c5cc626-816e-427e-83ab-0955940f0ced,44190742,8792,2120,2103,17,28,109
422,8c5cc626-816e-427e-83ab-0955940f0ced,44190742,8792,2121,2121,0,29,109
422,8c5cc626-816e-427e-83ab-0955940f0ced,44190742,8792,2167,2124,43,30,109
422,8c5cc626-816e-427e-83ab-0955940f0ced,44190742,8792,2169,2168,1,31,109
422,8c5cc626-816e-427e-83ab-0955940f0ced,44190742,8792,2168,2162,-6,32,109
422,8c5cc626-816e-427e-83ab-0955940f0ced,44190742,8792,2312,2164,148,33,109
422,8c5cc626-816e-427e-83ab-0955940f0ced,44190742,8792,2532,2337,195,34,109
422,8c5cc626-816e-427e-83ab-0955940f0ced,44190742,8792,2735,2546,189,35,109
422,8c5cc626-816e-427e-83ab-0955940f0ced,44190742,8792,2760,2736,24,36,109
422,8c5cc626-816e-427e-83ab-0955940f0ced,44190742,8792,2954,2763,191,37,109
422,8c5cc626-816e-427e-83ab-0955940f0ced,44190742,8792,3027,2916,111,38,109
422,8c5cc626-816e-427e-83ab-0955940f0ced,44190742,8792,3102,3032,70,39,109
422,8c5cc626-816e-427e-83ab-0955940f0ced,44190742,8792,3537,3122,415,47,109
422,8c5cc626-816e-427e-83ab-0955940f0ced,44190742,8792,3617,3541,76,48,109
422,8c5cc626-816e-427e-83ab-0955940f0ced,44190742,8792,3725,3620,105,53,109
422,8c5cc626-816e-427e-83ab-0955940f0ced,44190742,8792,3834,3727,107,54,109
422,8c5cc626-816e-427e-83ab-0955940f0ced,44190742,8792,3970,3841,129,55,109
422,8c5cc626-816e-427e-83ab-0955940f0ced,44190742,8792,4274,3972,302,59,109
422,8c5cc626-816e-427e-83ab-0955940f0ced,44190742,8792,4332,4277,55,60,109
422,8c5cc626-816e-427e-83ab-0955940f0ced,44190742,8792,4498,4336,162,61,109
422,8c5cc626-816e-427e-83ab-0955940f0ced,44190742,8792,4512,4500,12,62,109
422,8c5cc626-816e-427e-83ab-0955940f0ced,44190742,8792,4621,4513,108,63,109
422,8c5cc626-816e-427e-83ab-0955940f0ced,44190742,8792,4743,4622,121,64,109
422,8c5cc626-816e-427e-83ab-0955940f0ced,44190742,8792,4836,4749,87,65,109
422,8c5cc626-816e-427e-83ab-0955940f0ced,44190742,8792,4913,4838,75,71,109
422,8c5cc626-816e-427e-83ab-0955940f0ced,44190742,8792,5188,4914,274,72,109
422,8c5cc626-816e-427e-83ab-0955940f0ced,44190742,8792,5430,5189,241,73,109
422,8c5cc626-816e-427e-83ab-0955940f0ced,44190742,8792,5592,5440,152,81,109
422,8c5cc626-816e-427e-83ab-0955940f0ced,44190742,8792,5959,5601,358,82,109
422,8c5cc626-816e-427e-83ab-0955940f0ced,44190742,8792,6215,5967,248,83,109
422,8c5cc626-816e-427e-83ab-0955940f0ced,44190742,8792,6224,6218,6,84,109
422,8c5cc626-816e-427e-83ab-0955940f0ced,44190742,8792,6380,6226,154,89,109
422,8c5cc626-816e-427e-83ab-0955940f0ced,44190742,8792,6571,6384,187,90,109
422,8c5cc626-816e-427e-83ab-0955940f0ced,44190742,8792,6699,6574,125,91,109
422,8c5cc626-816e-427e-83ab-0955940f0ced,44190742,8792,6748,6701,47,92,109
422,8c5cc626-816e-427e-83ab-0955940f0ced,44190742,8792,6926,6760,166,93,109
422,8c5cc626-816e-427e-83ab-0955940f0ced,44190742,8792,6937,6927,10,94,109
422,8c5cc626-816e-427e-83ab-0955940f0ced,44190742,8792,7097,6942,155,95,109
422,8c5cc626-816e-427e-83ab-0955940f0ced,44190742,8792,7337,7099,238,96,109
422,8c5cc626-816e-427e-83ab-0955940f0ced,44190742,8792,7454,7357,97,106,109
422,8c5cc626-816e-427e-83ab-0955940f0ced,44190742,8792,7654,7471,183,107,109
422,8c5cc626-816e-427e-83ab-0955940f0ced,44190742,8792,7826,7672,154,108,109
422,8c5cc626-816e-427e-83ab-0955940f0ced,44190742,8792,7872,7827,45,109,109
423,81ffd00f-b5d0-4b37-b99b-77a8e2b4272e,44200621,10470,352,1,351,0,234
423,81ffd00f-b5d0-4b37-b99b-77a8e2b4272e,44200621,10470,550,369,181,1,234
423,81ffd00f-b5d0-4b37-b99b-77a8e2b4272e,44200621,10470,808,559,249,2,234
423,81ffd00f-b5d0-4b37-b99b-77a8e2b4272e,44200621,10470,934,810,124,3,234
423,81ffd00f-b5d0-4b37-b99b-77a8e2b4272e,44200621,10470,941,836,-105,4,234
423,81ffd00f-b5d0-4b37-b99b-77a8e2b4272e,44200621,10470,966,842,124,9,234
423,81ffd00f-b5d0-4b37-b99b-77a8e2b4272e,44200621,10470,997,972,25,10,234
423,81ffd00f-b5d0-4b37-b99b-77a8e2b4272e,44200621,10470,1158,1008,150,12,234
423,81ffd00f-b5d0-4b37-b99b-77a8e2b4272e,44200621,10470,1185,1165,20,16,234
423,81ffd00f-b5d0-4b37-b99b-77a8e2b4272e,44200621,10470,1279,1195,84,17,234
423,81ffd00f-b5d0-4b37-b99b-77a8e2b4272e,44200621,10470,1394,1255,139,26,234
423,81ffd00f-b5d0-4b37-b99b-77a8e2b4272e,44200621,10470,1686,1415,271,29,234
423,81ffd00f-b5d0-4b37-b99b-77a8e2b4272e,44200621,10470,1732,1691,41,30,234
423,81ffd00f-b5d0-4b37-b99b-77a8e2b4272e,44200621,10470,1765,1737,28,31,234
423,81ffd00f-b5d0-4b37-b99b-77a8e2b4272e,44200621,10470,1893,1766,127,32,234
423,81ffd00f-b5d0-4b37-b99b-77a8e2b4272e,44200621,10470,2005,1903,102,33,234
423,81ffd00f-b5d0-4b37-b99b-77a8e2b4272e,44200621,10470,2075,2010,65,37,234
423,81ffd00f-b5d0-4b37-b99b-77a8e2b4272e,44200621,10470,2180,2085,95,41,234
423,81ffd00f-b5d0-4b37-b99b-77a8e2b4272e,44200621,10470,2371,2192,179,42,234
423,81ffd00f-b5d0-4b37-b99b-77a8e2b4272e,44200621,10470,2534,2377,157,51,234
423,81ffd00f-b5d0-4b37-b99b-77a8e2b4272e,44200621,10470,2594,2536,58,57,234
423,81ffd00f-b5d0-4b37-b99b-77a8e2b4272e,44200621,10470,2644,2598,46,60,234
423,81ffd00f-b5d0-4b37-b99b-77a8e2b4272e,44200621,10470,2843,2648,195,66,234
423,81ffd00f-b5d0-4b37-b99b-77a8e2b4272e,44200621,10470,2908,2853,55,73,234
423,81ffd00f-b5d0-4b37-b99b-77a8e2b4272e,44200621,10470,3010,2915,95,74,234
423,81ffd00f-b5d0-4b37-b99b-77a8e2b4272e,44200621,10470,3112,3016,96,76,234
423,81ffd00f-b5d0-4b37-b99b-77a8e2b4272e,44200621,10470,3215,3121,94,83,234
423,81ffd00f-b5d0-4b37-b99b-77a8e2b4272e,44200621,10470,3249,3216,33,84,234
423,81ffd00f-b5d0-4b37-b99b-77a8e2b4272e,44200621,10470,3380,3259,121,88,234
423,81ffd00f-b5d0-4b37-b99b-77a8e2b4272e,44200621,10470,3476,3389,87,93,234
423,81ffd00f-b5d0-4b37-b99b-77a8e2b4272e,44200621,10470,3535,3478,57,94,234
423,81ffd00f-b5d0-4b37-b99b-77a8e2b4272e,44200621,10470,3592,3542,50,95,234
423,81ffd00f-b5d0-4b37-b99b-77a8e2b4272e,44200621,10470,3657,3603,54,97,234
423,81ffd00f-b5d0-4b37-b99b-77a8e2b4272e,44200621,10470,3678,3658,20,98,234
423,81ffd00f-b5d0-4b37-b99b-77a8e2b4272e,44200621,10470,3722,3683,39,104,234
423,81ffd00f-b5d0-4b37-b99b-77a8e2b4272e,44200621,10470,3801,3730,71,106,234
423,81ffd00f-b5d0-4b37-b99b-77a8e2b4272e,44200621,10470,3841,3812,29,107,234
423,81ffd00f-b5d0-4b37-b99b-77a8e2b4272e,44200621,10470,3945,3847,98,110,234
423,81ffd00f-b5d0-4b37-b99b-77a8e2b4272e,44200621,10470,3951,3951,0,115,234
423,81ffd00f-b5d0-4b37-b99b-77a8e2b4272e,44200621,10470,4078,3960,118,116,234
423,81ffd00f-b5d0-4b37-b99b-77a8e2b4272e,44200621,10470,4168,4084,84,117,234
423,81ffd00f-b5d0-4b37-b99b-77a8e2b4272e,44200621,10470,4178,4178,0,123,234
423,81ffd00f-b5d0-4b37-b99b-77a8e2b4272e,44200621,10470,4357,4188,169,124,234
423,81ffd00f-b5d0-4b37-b99b-77a8e2b4272e,44200621,10470,4493,4363,130,133,234
423,81ffd00f-b5d0-4b37-b99b-77a8e2b4272e,44200621,10470,4695,4494,201,136,234
423,81ffd00f-b5d0-4b37-b99b-77a8e2b4272e,44200621,10470,4704,4696,8,137,234
423,81ffd00f-b5d0-4b37-b99b-77a8e2b4272e,44200621,10470,4814,4710,104,138,234
423,81ffd00f-b5d0-4b37-b99b-77a8e2b4272e,44200621,10470,4834,4815,19,139,234
423,81ffd00f-b5d0-4b37-b99b-77a8e2b4272e,44200621,10470,4844,4825,-19,140,234
423,81ffd00f-b5d0-4b37-b99b-77a8e2b4272e,44200621,10470,4950,4832,118,150,234
423,81ffd00f-b5d0-4b37-b99b-77a8e2b4272e,44200621,10470,5102,4952,150,156,234
423,81ffd00f-b5d0-4b37-b99b-77a8e2b4272e,44200621,10470,5202,5114,88,158,234
423,81ffd00f-b5d0-4b37-b99b-77a8e2b4272e,44200621,10470,5287,5203,84,165,234
423,81ffd00f-b5d0-4b37-b99b-77a8e2b4272e,44200621,10470,5370,5294,76,174,234
423,81ffd00f-b5d0-4b37-b99b-77a8e2b4272e,44200621,10470,5412,5371,41,175,234
423,81ffd00f-b5d0-4b37-b99b-77a8e2b4272e,44200621,10470,5447,5418,29,178,234
423,81ffd00f-b5d0-4b37-b99b-77a8e2b4272e,44200621,10470,5543,5455,88,179,234
423,81ffd00f-b5d0-4b37-b99b-77a8e2b4272e,44200621,10470,5527,5327,-200,180,234
423,81ffd00f-b5d0-4b37-b99b-77a8e2b4272e,44200621,10470,5396,5333,63,181,234
423,81ffd00f-b5d0-4b37-b99b-77a8e2b4272e,44200621,10470,5533,5397,136,182,234
423,81ffd00f-b5d0-4b37-b99b-77a8e2b4272e,44200621,10470,5592,5534,58,183,234
423,81ffd00f-b5d0-4b37-b99b-77a8e2b4272e,44200621,10470,5754,5596,158,188,234
423,81ffd00f-b5d0-4b37-b99b-77a8e2b4272e,44200621,10470,5870,5761,109,189,234
423,81ffd00f-b5d0-4b37-b99b-77a8e2b4272e,44200621,10470,5786,5763,-23,190,234
423,81ffd00f-b5d0-4b37-b99b-77a8e2b4272e,44200621,10470,5862,5767,95,197,234
423,81ffd00f-b5d0-4b37-b99b-77a8e2b4272e,44200621,10470,6014,5872,142,199,234
423,81ffd00f-b5d0-4b37-b99b-77a8e2b4272e,44200621,10470,6179,6022,157,200,234
423,81ffd00f-b5d0-4b37-b99b-77a8e2b4272e,44200621,10470,6216,6182,34,201,234
423,81ffd00f-b5d0-4b37-b99b-77a8e2b4272e,44200621,10470,6728,6219,509,203,234
423,81ffd00f-b5d0-4b37-b99b-77a8e2b4272e,44200621,10470,6787,6740,47,204,234
423,81ffd00f-b5d0-4b37-b99b-77a8e2b4272e,44200621,10470,7032,6790,242,205,234
423,81ffd00f-b5d0-4b37-b99b-77a8e2b4272e,44200621,10470,7231,7042,189,211,234
423,81ffd00f-b5d0-4b37-b99b-77a8e2b4272e,44200621,10470,7357,7238,119,214,234
423,81ffd00f-b5d0-4b37-b99b-77a8e2b4272e,44200621,10470,7523,7384,139,226,234
423,81ffd00f-b5d0-4b37-b99b-77a8e2b4272e,44200621,10470,7556,7524,32,227,234
423,81ffd00f-b5d0-4b37-b99b-77a8e2b4272e,44200621,10470,7597,7557,40,228,234
423,81ffd00f-b5d0-4b37-b99b-77a8e2b4272e,44200621,10470,7712,7601,111,230,234
423,81ffd00f-b5d0-4b37-b99b-77a8e2b4272e,44200621,10470,7757,7714,43,231,234
423,81ffd00f-b5d0-4b37-b99b-77a8e2b4272e,44200621,10470,7806,7765,41,232,234
423,81ffd00f-b5d0-4b37-b99b-77a8e2b4272e,44200621,10470,7962,7817,145,233,234
423,81ffd00f-b5d0-4b37-b99b-77a8e2b4272e,44200621,10470,8067,7968,99,234,234
423,81ffd00f-b5d0-4b37-b99b-77a8e2b4272e,44202102,3383,291,16,275,0,7
423,81ffd00f-b5d0-4b37-b99b-77a8e2b4272e,44202102,3383,578,297,281,1,7
423,81ffd00f-b5d0-4b37-b99b-77a8e2b4272e,44202102,3383,669,579,90,2,7
423,81ffd00f-b5d0-4b37-b99b-77a8e2b4272e,44202102,3383,823,683,140,3,7
423,81ffd00f-b5d0-4b37-b99b-77a8e2b4272e,44202102,3383,1056,826,230,4,7
423,81ffd00f-b5d0-4b37-b99b-77a8e2b4272e,44202102,3383,1260,1057,203,5,7
423,81ffd00f-b5d0-4b37-b99b-77a8e2b4272e,44202102,3383,1486,1269,217,6,7
423,81ffd00f-b5d0-4b37-b99b-77a8e2b4272e,44202102,3383,1591,1487,104,7,7
423,81ffd00f-b5d0-4b37-b99b-77a8e2b4272e,44203679,7173,603,3,600,0,49
423,81ffd00f-b5d0-4b37-b99b-77a8e2b4272e,44203679,7173,1020,636,384,1,49
423,81ffd00f-b5d0-4b37-b99b-77a8e2b4272e,44203679,7173,1191,1026,165,2,49
423,81ffd00f-b5d0-4b37-b99b-77a8e2b4272e,44203679,7173,1297,1194,103,3,49
423,81ffd00f-b5d0-4b37-b99b-77a8e2b4272e,44203679,7173,1403,1303,100,5,49
423,81ffd00f-b5d0-4b37-b99b-77a8e2b4272e,44203679,7173,1424,1405,19,6,49
423,81ffd00f-b5d0-4b37-b99b-77a8e2b4272e,44203679,7173,1540,1428,112,13,49
423,81ffd00f-b5d0-4b37-b99b-77a8e2b4272e,44203679,7173,1569,1541,28,14,49
423,81ffd00f-b5d0-4b37-b99b-77a8e2b4272e,44203679,7173,1687,1573,114,25,49
423,81ffd00f-b5d0-4b37-b99b-77a8e2b4272e,44203679,7173,1734,1698,36,40,49
423,81ffd00f-b5d0-4b37-b99b-77a8e2b4272e,44203679,7173,1816,1743,73,41,49
423,81ffd00f-b5d0-4b37-b99b-77a8e2b4272e,44203679,7173,1849,1817,32,45,49
423,81ffd00f-b5d0-4b37-b99b-77a8e2b4272e,44203679,7173,1906,1859,47,46,49
423,81ffd00f-b5d0-4b37-b99b-77a8e2b4272e,44203679,7173,2354,1912,442,49,49
423,81ffd00f-b5d0-4b37-b99b-77a8e2b4272e,44195948,6184,670,21,649,0,75
423,81ffd00f-b5d0-4b37-b99b-77a8e2b4272e,44195948,6184,995,681,314,1,75
423,81ffd00f-b5d0-4b37-b99b-77a8e2b4272e,44195948,6184,1189,998,191,11,75
423,81ffd00f-b5d0-4b37-b99b-77a8e2b4272e,44195948,6184,1336,1192,144,21,75
423,81ffd00f-b5d0-4b37-b99b-77a8e2b4272e,44195948,6184,1367,1337,30,22,75
423,81ffd00f-b5d0-4b37-b99b-77a8e2b4272e,44195948,6184,1422,1372,50,44,75
423,81ffd00f-b5d0-4b37-b99b-77a8e2b4272e,44195948,6184,1454,1427,27,45,75
423,81ffd00f-b5d0-4b37-b99b-77a8e2b4272e,44195948,6184,1562,1455,107,56,75
423,81ffd00f-b5d0-4b37-b99b-77a8e2b4272e,44195948,6184,2801,1567,1234,74,75
423,81ffd00f-b5d0-4b37-b99b-77a8e2b4272e,44195948,6184,3828,2867,961,75,75
423,81ffd00f-b5d0-4b37-b99b-77a8e2b4272e,44202312,7013,326,4,322,0,15
423,81ffd00f-b5d0-4b37-b99b-77a8e2b4272e,44202312,7013,461,333,128,1,15
423,81ffd00f-b5d0-4b37-b99b-77a8e2b4272e,44202312,7013,924,469,455,4,15
423,81ffd00f-b5d0-4b37-b99b-77a8e2b4272e,44202312,7013,954,931,23,5,15
423,81ffd00f-b5d0-4b37-b99b-77a8e2b4272e,44202312,7013,1246,1001,245,7,15
423,81ffd00f-b5d0-4b37-b99b-77a8e2b4272e,44202312,7013,1788,1255,533,11,15
423,81ffd00f-b5d0-4b37-b99b-77a8e2b4272e,44202312,7013,1996,1813,183,12,15
423,81ffd00f-b5d0-4b37-b99b-77a8e2b4272e,44202312,7013,2592,2027,565,13,15
423,81ffd00f-b5d0-4b37-b99b-77a8e2b4272e,44202312,7013,5103,2629,2474,14,15
423,81ffd00f-b5d0-4b37-b99b-77a8e2b4272e,44202312,7013,5266,5152,114,15,15
424,82014d60-826c-4956-892f-0e437e1ed2a2,44199844,8433,531,4,527,0,262
424,82014d60-826c-4956-892f-0e437e1ed2a2,44199844,8433,547,535,12,1,262
424,82014d60-826c-4956-892f-0e437e1ed2a2,44199844,8433,977,558,419,6,262
424,82014d60-826c-4956-892f-0e437e1ed2a2,44199844,8433,1148,982,166,20,262
424,82014d60-826c-4956-892f-0e437e1ed2a2,44199844,8433,1644,1200,444,21,262
424,82014d60-826c-4956-892f-0e437e1ed2a2,44199844,8433,1728,1652,76,22,262
424,82014d60-826c-4956-892f-0e437e1ed2a2,44199844,8433,1821,1732,89,33,262
424,82014d60-826c-4956-892f-0e437e1ed2a2,44199844,8433,1911,1828,83,34,262
424,82014d60-826c-4956-892f-0e437e1ed2a2,44199844,8433,1983,1914,69,53,262
424,82014d60-826c-4956-892f-0e437e1ed2a2,44199844,8433,2164,2003,161,55,262
424,82014d60-826c-4956-892f-0e437e1ed2a2,44199844,8433,2176,2168,8,56,262
424,82014d60-826c-4956-892f-0e437e1ed2a2,44199844,8433,2620,2184,436,162,262
424,82014d60-826c-4956-892f-0e437e1ed2a2,44199844,8433,2777,2634,143,163,262
424,82014d60-826c-4956-892f-0e437e1ed2a2,44199844,8433,3162,2782,380,173,262
424,82014d60-826c-4956-892f-0e437e1ed2a2,44199844,8433,3427,3182,245,192,262
424,82014d60-826c-4956-892f-0e437e1ed2a2,44199844,8433,3573,3449,124,193,262
424,82014d60-826c-4956-892f-0e437e1ed2a2,44199844,8433,3984,3574,410,204,262
424,82014d60-826c-4956-892f-0e437e1ed2a2,44199844,8433,4130,4129,1,205,262
424,82014d60-826c-4956-892f-0e437e1ed2a2,44199844,8433,4355,4133,222,228,262
424,82014d60-826c-4956-892f-0e437e1ed2a2,44199844,8433,4389,4364,25,229,262
424,82014d60-826c-4956-892f-0e437e1ed2a2,44199844,8433,4971,4397,574,251,262
424,82014d60-826c-4956-892f-0e437e1ed2a2,44199844,8433,5128,5078,50,259,262
424,82014d60-826c-4956-892f-0e437e1ed2a2,44199844,8433,5828,5165,663,260,262
424,82014d60-826c-4956-892f-0e437e1ed2a2,44199844,8433,6387,5829,558,261,262
424,82014d60-826c-4956-892f-0e437e1ed2a2,44199844,8433,6909,6425,484,262,262
424,82014d60-826c-4956-892f-0e437e1ed2a2,44197118,5802,195,4,191,0,122
424,82014d60-826c-4956-892f-0e437e1ed2a2,44197118,5802,286,214,72,1,122
424,82014d60-826c-4956-892f-0e437e1ed2a2,44197118,5802,402,302,100,2,122
424,82014d60-826c-4956-892f-0e437e1ed2a2,44197118,5802,664,406,258,3,122
424,82014d60-826c-4956-892f-0e437e1ed2a2,44197118,5802,830,675,155,18,122
424,82014d60-826c-4956-892f-0e437e1ed2a2,44197118,5802,1033,846,187,33,122
424,82014d60-826c-4956-892f-0e437e1ed2a2,44197118,5802,1182,1043,139,47,122
424,82014d60-826c-4956-892f-0e437e1ed2a2,44197118,5802,1186,1183,3,48,122
424,82014d60-826c-4956-892f-0e437e1ed2a2,44197118,5802,1659,1187,472,53,122
424,82014d60-826c-4956-892f-0e437e1ed2a2,44197118,5802,1684,1665,19,54,122
424,82014d60-826c-4956-892f-0e437e1ed2a2,44197118,5802,1863,1685,178,65,122
424,82014d60-826c-4956-892f-0e437e1ed2a2,44197118,5802,2120,1867,253,71,122
424,82014d60-826c-4956-892f-0e437e1ed2a2,44197118,5802,2124,2121,3,72,122
424,82014d60-826c-4956-892f-0e437e1ed2a2,44197118,5802,2644,2129,515,90,122
424,82014d60-826c-4956-892f-0e437e1ed2a2,44197118,5802,2688,2652,36,100,122
424,82014d60-826c-4956-892f-0e437e1ed2a2,44197118,5802,2846,2697,149,101,122
424,82014d60-826c-4956-892f-0e437e1ed2a2,44197118,5802,2992,2862,130,105,122
424,82014d60-826c-4956-892f-0e437e1ed2a2,44197118,5802,3529,3007,522,116,122
424,82014d60-826c-4956-892f-0e437e1ed2a2,44197118,5802,3904,3572,332,118,122
424,82014d60-826c-4956-892f-0e437e1ed2a2,44197118,5802,3945,3912,33,119,122
424,82014d60-826c-4956-892f-0e437e1ed2a2,44197118,5802,4278,3963,315,122,122
424,82014d60-826c-4956-892f-0e437e1ed2a2,44200041,7989,234,12,222,0,560
424,82014d60-826c-4956-892f-0e437e1ed2a2,44200041,7989,379,250,129,3,560
424,82014d60-826c-4956-892f-0e437e1ed2a2,44200041,7989,667,401,266,4,560
424,82014d60-826c-4956-892f-0e437e1ed2a2,44200041,7989,1031,700,331,9,560
424,82014d60-826c-4956-892f-0e437e1ed2a2,44200041,7989,1467,1096,371,23,560
424,82014d60-826c-4956-892f-0e437e1ed2a2,44200041,7989,2258,1480,778,24,560
424,82014d60-826c-4956-892f-0e437e1ed2a2,44200041,7989,2442,2264,178,79,560
424,82014d60-826c-4956-892f-0e437e1ed2a2,44200041,7989,2660,2443,217,80,560
424,82014d60-826c-4956-892f-0e437e1ed2a2,44200041,7989,2998,2669,329,83,560
424,82014d60-826c-4956-892f-0e437e1ed2a2,44200041,7989,3483,3009,474,86,560
424,82014d60-826c-4956-892f-0e437e1ed2a2,44200041,7989,3501,3487,14,87,560
424,82014d60-826c-4956-892f-0e437e1ed2a2,44200041,7989,3711,3517,194,90,560
424,82014d60-826c-4956-892f-0e437e1ed2a2,44200041,1524,0,0,0,94,560
424,82014d60-826c-4956-892f-0e437e1ed2a2,44200041,7989,1586,69,1517,392,560
424,82014d60-826c-4956-892f-0e437e1ed2a2,44200041,7989,4689,1732,2957,393,560
424,82014d60-826c-4956-892f-0e437e1ed2a2,44200041,7989,4072,0,-4072,394,560
424,82014d60-826c-4956-892f-0e437e1ed2a2,44200041,7989,3318,84,3234,482,560
424,82014d60-826c-4956-892f-0e437e1ed2a2,44200041,7989,3376,2958,418,483,560
424,82014d60-826c-4956-892f-0e437e1ed2a2,44200041,7989,3809,3387,422,484,560
424,82014d60-826c-4956-892f-0e437e1ed2a2,44200041,1524,0,0,0,485,560
424,82014d60-826c-4956-892f-0e437e1ed2a2,44200041,7989,2273,32,2241,497,560
424,82014d60-826c-4956-892f-0e437e1ed2a2,44200041,7989,3697,2306,1391,498,560
424,82014d60-826c-4956-892f-0e437e1ed2a2,44200041,7989,3702,3529,-173,499,560
424,82014d60-826c-4956-892f-0e437e1ed2a2,44200041,1524,0,0,0,560,560
402,56352eb9-0016-485b-ab29-174ff1349ac2,44705158,5751,610,43,567,0,14
402,56352eb9-0016-485b-ab29-174ff1349ac2,44705158,5751,642,616,26,1,14
402,56352eb9-0016-485b-ab29-174ff1349ac2,44705158,5751,978,671,307,4,14
402,56352eb9-0016-485b-ab29-174ff1349ac2,44705158,5751,1146,973,173,12,14
402,56352eb9-0016-485b-ab29-174ff1349ac2,44705158,5751,2562,1200,1362,13,14
402,56352eb9-0016-485b-ab29-174ff1349ac2,44705158,5751,2604,2573,31,14,14
427,2b92b40e-373e-4dde-9c55-6534f88f8574,44771792,6006,896,18,878,0,1
427,2b92b40e-373e-4dde-9c55-6534f88f8574,44771792,6006,4608,958,3650,1,1
427,2b92b40e-373e-4dde-9c55-6534f88f8574,44758589,9291,1134,16,1118,0,5
427,2b92b40e-373e-4dde-9c55-6534f88f8574,44758589,9291,5503,1309,4194,1,5
427,2b92b40e-373e-4dde-9c55-6534f88f8574,44758589,9291,4241,0,-4241,2,5
427,2b92b40e-373e-4dde-9c55-6534f88f8574,44758589,9291,7893,17,7876,5,5
428,eb35eeac-f294-44a4-ae4a-f4472c04f268,45462999,2544,267,2,265,0,33
428,eb35eeac-f294-44a4-ae4a-f4472c04f268,45462999,2544,346,278,68,1,33
428,eb35eeac-f294-44a4-ae4a-f4472c04f268,45462999,2544,330,0,-330,33,33
428,eb35eeac-f294-44a4-ae4a-f4472c04f268,45445554,4046,21,2,19,0,72
428,eb35eeac-f294-44a4-ae4a-f4472c04f268,45445554,4046,657,34,623,1,72
428,eb35eeac-f294-44a4-ae4a-f4472c04f268,45445554,4046,1365,667,698,2,72
428,eb35eeac-f294-44a4-ae4a-f4472c04f268,45445554,4046,1565,1374,191,3,72
428,eb35eeac-f294-44a4-ae4a-f4472c04f268,45445554,4046,1684,1567,117,5,72
428,eb35eeac-f294-44a4-ae4a-f4472c04f268,45445554,4046,1717,1687,30,6,72
428,eb35eeac-f294-44a4-ae4a-f4472c04f268,45445554,4046,1847,1719,128,14,72
428,eb35eeac-f294-44a4-ae4a-f4472c04f268,45445554,4046,1848,1848,0,15,72
428,eb35eeac-f294-44a4-ae4a-f4472c04f268,45445554,4046,1848,1733,115,48,72
428,eb35eeac-f294-44a4-ae4a-f4472c04f268,45445554,4046,1840,994,-846,71,72
428,eb35eeac-f294-44a4-ae4a-f4472c04f268,45445554,4046,823,0,-823,72,72